County,State,State FIPS Code,County FIPS Code,fips,Total Population,Male Population,Female Population,Total Race Responses,White Alone,Black or African American Alone,Hispanic or Latino,,White Population,Black Population,Hispanic/Latino Population,,,Total
Autauga County,Alabama,01,001,1001,59285,28669,30616,59285,43616,11829,2188,,0.73570043,0.199527705,0.036906469,,,0.972134604
Baldwin County,Alabama,01,003,1003,239945,117316,122629,239945,198721,19144,13393,,0.828193961,0.079784951,0.055816958,,,
Barbour County,Alabama,01,005,1005,24757,12906,11851,24757,10891,11616,1490,,0.439915983,0.46920063,0.060184998,,,
Bibb County,Alabama,01,007,1007,22152,11824,10328,22152,16634,4587,744,,0.750902853,0.207069339,0.033586132,,,
Blount County,Alabama,01,009,1009,59292,29934,29358,59292,53062,747,5962,,0.894926803,0.012598664,0.100553194,,,
Bullock County,Alabama,01,011,1011,10157,5554,4603,10157,2327,7234,577,,0.229103082,0.712218175,0.056808113,,,
Butler County,Alabama,01,013,1013,18807,8656,10151,18807,9622,8411,300,,0.511618015,0.447227096,0.015951507,,,
Calhoun County,Alabama,01,015,1015,116141,56151,59990,116141,82465,25515,5150,,0.710042104,0.21968986,0.044342652,,,
Chambers County,Alabama,01,017,1017,34450,16080,18370,34450,19089,13697,1270,,0.554107402,0.397590711,0.036865022,,,
Cherokee County,Alabama,01,019,1019,25224,12423,12801,25224,23017,948,437,,0.912503964,0.037583254,0.01732477,,,
Chilton County,Alabama,01,021,1021,45500,22245,23255,45500,36815,4175,4489,,0.809120879,0.091758242,0.098659341,,,
Choctaw County,Alabama,01,023,1023,12525,5872,6653,12525,7101,4782,136,,0.566946108,0.381796407,0.010858283,,,
Clarke County,Alabama,01,025,1025,22802,10789,12013,22802,11749,10360,261,,0.515261819,0.45434611,0.011446364,,,
Clay County,Alabama,01,027,1027,14188,6835,7353,14188,11424,1840,451,,0.805187482,0.129687059,0.031787426,,,
Cleburne County,Alabama,01,029,1029,15254,7652,7602,15254,14158,598,306,,0.928149993,0.039202832,0.020060312,,,
Coffee County,Alabama,01,031,1031,54231,26968,27263,54231,38780,8991,5096,,0.715089156,0.165790784,0.093968394,,,
Colbert County,Alabama,01,033,1033,57648,27784,29864,57648,44984,9103,1890,,0.780321954,0.157906606,0.032785179,,,
Conecuh County,Alabama,01,035,1035,11411,5297,6114,11411,5730,5221,101,,0.502147051,0.457540969,0.008851109,,,
Coosa County,Alabama,01,037,1037,10323,5289,5034,10323,6664,3065,245,,0.645548775,0.296909813,0.023733411,,,
Covington County,Alabama,01,039,1039,37647,18172,19475,37647,31325,4417,727,,0.832071613,0.117326746,0.019310968,,,
Crenshaw County,Alabama,01,041,1041,13144,6366,6778,13144,9280,3071,236,,0.706025563,0.233642727,0.01795496,,,
Cullman County,Alabama,01,043,1043,89463,44284,45179,89463,81402,958,4346,,0.909895711,0.010708338,0.048578742,,,
Dale County,Alabama,01,045,1045,49516,24398,25118,49516,33971,10504,3431,,0.686061071,0.212133452,0.069290734,,,
Dallas County,Alabama,01,047,1047,37536,17409,20127,37536,10207,26467,340,,0.271925618,0.705109761,0.009057971,,,
DeKalb County,Alabama,01,049,1049,71946,35969,35977,71946,58471,923,11987,,0.812706752,0.012829066,0.166611069,,,
Elmore County,Alabama,01,051,1051,88669,43186,45483,88669,64984,18685,2917,,0.732882969,0.210727537,0.032897631,,,
Escambia County,Alabama,01,053,1053,36695,18346,18349,36695,22378,11255,835,,0.609837853,0.306717536,0.022755144,,,
Etowah County,Alabama,01,055,1055,103208,50001,53207,103208,79768,15529,5134,,0.772885823,0.150463142,0.049744206,,,
Fayette County,Alabama,01,057,1057,16173,7863,8310,16173,13662,1983,184,,0.844741235,0.12261176,0.011376986,,,
Franklin County,Alabama,01,059,1059,31978,15776,16202,31978,24208,1287,6341,,0.757020452,0.040246419,0.198292576,,,
Geneva County,Alabama,01,061,1061,26726,13107,13619,26726,22539,2311,1353,,0.843336077,0.086470104,0.05062486,,,
Greene County,Alabama,01,063,1063,7589,3649,3940,7589,1360,6186,57,,0.179206747,0.815127158,0.007510871,,,
Hale County,Alabama,01,065,1065,14749,7045,7704,14749,5666,8225,129,,0.384161638,0.557664926,0.008746356,,,
Henry County,Alabama,01,067,1067,17450,8514,8936,17450,12385,4394,374,,0.70974212,0.251805158,0.021432665,,,
Houston County,Alabama,01,069,1069,107628,51690,55938,107628,70462,29302,4680,,0.654680938,0.272252574,0.043483108,,,
Jackson County,Alabama,01,071,1071,52839,26138,26701,52839,47005,1607,1777,,0.889589129,0.030413142,0.033630462,,,
Jefferson County,Alabama,01,073,1073,669744,318051,351693,669744,329852,284390,35103,,0.492504599,0.424624931,0.052412564,,,
Lamar County,Alabama,01,075,1075,13809,6772,7037,13809,11954,1282,255,,0.865667318,0.092838004,0.018466218,,,
Lauderdale County,Alabama,01,077,1077,95037,45668,49369,95037,79325,9205,3163,,0.834674916,0.096857014,0.033281774,,,
Lawrence County,Alabama,01,079,1079,33182,16321,16861,33182,25239,3292,953,,0.760623229,0.099210415,0.028720391,,,
Lee County,Alabama,01,081,1081,177663,87729,89934,177663,120347,39670,9335,,0.677389214,0.22328791,0.052543298,,,
Limestone County,Alabama,01,083,1083,107577,53922,53655,107577,81012,13720,7785,,0.753060598,0.127536555,0.07236677,,,
Lowndes County,Alabama,01,085,1085,10008,4801,5207,10008,2451,7460,27,,0.244904077,0.745403677,0.002697842,,,
Macon County,Alabama,01,087,1087,18951,8709,10242,18951,3243,14838,372,,0.171125534,0.782966598,0.019629571,,,
Madison County,Alabama,01,089,1089,397135,195432,201703,397135,255048,96369,25948,,0.6422199,0.242660556,0.065337983,,,
Marengo County,Alabama,01,091,1091,19027,9012,10015,19027,8571,9768,452,,0.450465129,0.513375729,0.023755716,,,
Marion County,Alabama,01,093,1093,29190,14414,14776,29190,26682,1043,879,,0.914080164,0.035731415,0.030113052,,,
Marshall County,Alabama,01,095,1095,98712,49059,49653,98712,81021,2579,16360,,0.820781668,0.026126509,0.165734662,,,
Mobile County,Alabama,01,097,1097,413162,197771,215391,413162,231919,148900,13778,,0.561327034,0.360391324,0.033347694,,,
Monroe County,Alabama,01,099,1099,19580,9455,10125,19580,10513,8260,29,,0.536925434,0.42185904,0.001481103,,,
Montgomery County,Alabama,01,101,1101,227197,106958,120239,227197,72196,133683,10796,,0.31776828,0.588401255,0.047518233,,,
Morgan County,Alabama,01,103,1103,123742,61066,62676,123742,93264,16262,12626,,0.753697209,0.131418597,0.102034879,,,
Perry County,Alabama,01,105,1105,8231,3772,4459,8231,2306,5843,18,,0.280160369,0.709877293,0.002186855,,,
Pickens County,Alabama,01,107,1107,18843,9111,9732,18843,10967,7400,1088,,0.582019848,0.392718782,0.057740275,,,
Pike County,Alabama,01,109,1109,32953,15718,17235,32953,18472,12320,889,,0.560555943,0.373865809,0.026977817,,,
Randolph County,Alabama,01,111,1111,22310,10934,11376,22310,16861,3677,635,,0.755759749,0.164813985,0.028462573,,,
Russell County,Alabama,01,113,1113,58858,28041,30817,58858,27421,26800,3382,,0.465883992,0.455333175,0.057460328,,,
St. Clair County,Alabama,01,115,1115,92903,45942,46961,92903,78348,9161,2670,,0.843331216,0.098608226,0.028739653,,,
Shelby County,Alabama,01,117,1117,226955,110544,116411,226955,173713,29906,16709,,0.765407239,0.131770615,0.073622524,,,
Sumter County,Alabama,01,119,1119,12020,5357,6663,12020,3109,8557,100,,0.258652246,0.711896839,0.008319468,,,
Talladega County,Alabama,01,121,1121,81170,39466,41704,81170,50918,25750,1879,,0.627300727,0.317235432,0.023148947,,,
Tallapoosa County,Alabama,01,123,1123,41070,19970,21100,41070,28233,9607,1137,,0.687436085,0.233917701,0.027684441,,,
Tuscaloosa County,Alabama,01,125,1125,234036,113056,120980,234036,142461,74775,12593,,0.608714044,0.319502128,0.053807961,,,
Walker County,Alabama,01,127,1127,64886,31859,33027,64886,57003,3958,2253,,0.878510002,0.060999291,0.034722436,,,
Washington County,Alabama,01,129,1129,15270,7600,7670,15270,10220,3463,255,,0.669286182,0.226784545,0.016699411,,,
Wilcox County,Alabama,01,131,1131,10347,4953,5394,10347,2852,7318,11,,0.27563545,0.707258142,0.00106311,,,
Winston County,Alabama,01,133,1133,23637,11799,11838,23637,21927,284,826,,0.927655794,0.012015061,0.034945213,,,
Aleutians East Borough,Alaska,02,013,2013,3423,2116,1307,3423,568,206,360,,0.165936313,0.060181128,0.105170903,,,
Aleutians West Census Area,Alaska,02,016,2016,5178,3595,1583,5178,1274,273,715,,0.246040942,0.052723059,0.138084202,,,
Anchorage Municipality,Alaska,02,020,2020,289069,147620,141449,289069,168578,15280,26953,,0.583175643,0.052859352,0.093240714,,,
Bethel Census Area,Alaska,02,050,2050,18487,9885,8602,18487,1617,213,257,,0.087466869,0.01152161,0.013901661,,,
Bristol Bay Borough,Alaska,02,060,2060,878,536,342,878,423,5,73,,0.481776765,0.005694761,0.083143508,,,
Chugach Census Area,Alaska,02,063,2063,6964,3725,3239,6964,5053,96,359,,0.725588742,0.013785181,0.051550833,,,
Copper River Census Area,Alaska,02,066,2066,2626,1330,1296,2626,1403,3,102,,0.534272658,0.001142422,0.038842346,,,
Denali Borough,Alaska,02,068,2068,2029,1282,747,2029,1589,21,131,,0.783144406,0.010349926,0.064563825,,,
Dillingham Census Area,Alaska,02,070,2070,4780,2467,2313,4780,733,30,164,,0.15334728,0.006276151,0.034309623,,,
Fairbanks North Star Borough,Alaska,02,090,2090,95555,51899,43656,95555,67290,3677,7825,,0.704201769,0.038480456,0.081890011,,,
Haines Borough,Alaska,02,100,2100,2077,1051,1026,2077,1645,5,83,,0.792007703,0.002407318,0.039961483,,,
Hoonah-Angoon Census Area,Alaska,02,105,2105,2313,1321,992,2313,1183,20,250,,0.511456982,0.008646779,0.108084738,,,
Juneau City and Borough,Alaska,02,110,2110,31969,16350,15619,31969,20293,236,2234,,0.634771185,0.007382151,0.069880196,,,
Kenai Peninsula Borough,Alaska,02,122,2122,59843,31250,28593,59843,47318,337,2547,,0.790702338,0.005631402,0.042561369,,,
Ketchikan Gateway Borough,Alaska,02,130,2130,13870,7226,6644,13870,8812,60,730,,0.635328046,0.004325883,0.052631579,,,
Kodiak Island Borough,Alaska,02,150,2150,12878,6981,5897,12878,6557,78,1051,,0.509162913,0.006056841,0.081612052,,,
Kusilvak Census Area,Alaska,02,158,2158,8277,4431,3846,8277,264,73,136,,0.031895614,0.008819621,0.016431074,,,
Lake and Peninsula Borough,Alaska,02,164,2164,1007,545,462,1007,165,23,11,,0.163853029,0.022840119,0.010923535,,,
Matanuska-Susitna Borough,Alaska,02,170,2170,110677,57891,52786,110677,86657,1420,5748,,0.782972072,0.012830127,0.05193491,,,
Nome Census Area,Alaska,02,180,2180,9925,5189,4736,9925,1402,103,207,,0.141259446,0.010377834,0.020856423,,,
North Slope Borough,Alaska,02,185,2185,10891,6647,4244,10891,3444,284,578,,0.316224405,0.026076577,0.053071343,,,
Northwest Arctic Borough,Alaska,02,188,2188,7611,4018,3593,7611,795,43,159,,0.10445408,0.005649718,0.020890816,,,
Petersburg Borough,Alaska,02,195,2195,3394,1696,1698,3394,2095,50,303,,0.617265763,0.01473188,0.089275192,,,
Prince of Wales-Hyder Census Area,Alaska,02,198,2198,5730,3169,2561,5730,2547,21,207,,0.444502618,0.003664921,0.036125654,,,
Sitka City and Borough,Alaska,02,220,2220,8393,4367,4026,8393,5163,31,575,,0.615155487,0.003693554,0.068509472,,,
Skagway Municipality,Alaska,02,230,2230,1308,532,776,1308,918,29,64,,0.701834862,0.022171254,0.048929664,,,
Southeast Fairbanks Census Area,Alaska,02,240,2240,6936,3974,2962,6936,5277,61,402,,0.760813149,0.008794694,0.057958478,,,
Wrangell City and Borough,Alaska,02,275,2275,2106,1083,1023,2106,1161,2,116,,0.551282051,0.000949668,0.055080722,,,
Yakutat City and Borough,Alaska,02,282,2282,506,333,173,506,125,28,24,,0.247035573,0.055335968,0.04743083,,,
Yukon-Koyukuk Census Area,Alaska,02,290,2290,5271,2810,2461,5271,1196,66,109,,0.226901916,0.012521343,0.020679188,,,
Apache County,Arizona,04,001,4001,65680,32566,33114,65680,13296,625,4092,,0.202436054,0.009515834,0.062302071,,,
Cochise County,Arizona,04,003,4003,125458,63980,61478,125458,83752,4822,43077,,0.667570023,0.038435174,0.343357937,,,
Coconino County,Arizona,04,005,4005,144643,71482,73161,144643,82430,2197,22034,,0.569885857,0.015189121,0.152333677,,,
Gila County,Arizona,04,007,4007,53610,26803,26807,53610,36305,337,9529,,0.677205745,0.006286141,0.177746689,,,
Graham County,Arizona,04,009,4009,38860,20729,18131,38860,25739,498,11769,,0.662352033,0.012815234,0.302856408,,,
Greenlee County,Arizona,04,011,4011,9452,4946,4506,9452,6114,139,4396,,0.646847228,0.014705882,0.465086754,,,
La Paz County,Arizona,04,012,4012,16605,8577,8028,16605,10183,69,4230,,0.613249021,0.004155375,0.254742547,,,
Maricopa County,Arizona,04,013,4013,4491987,2233573,2258414,4491987,2828976,258962,1387720,,0.629782767,0.057649766,0.308932328,,,
Mohave County,Arizona,04,015,4015,217420,110104,107316,217420,177142,2519,36295,,0.814745654,0.011585871,0.166934965,,,
Navajo County,Arizona,04,017,4017,107744,54109,53635,107744,48887,1264,11466,,0.453732922,0.011731512,0.106418919,,,
Pima County,Arizona,04,019,4019,1049947,518998,530949,1049947,664037,37789,379548,,0.632448114,0.035991341,0.361492532,,,
Pinal County,Arizona,04,021,4021,449219,233422,215797,449219,296288,22607,131771,,0.659562485,0.05032512,0.293333541,,,
Santa Cruz County,Arizona,04,023,4023,48209,23266,24943,48209,20283,118,39875,,0.420730569,0.002447676,0.827127715,,,
Yavapai County,Arizona,04,025,4025,241656,119041,122615,241656,199789,1368,36225,,0.826749594,0.00566094,0.149903168,,,
Yuma County,Arizona,04,027,4027,207685,107098,100587,207685,100432,3617,133743,,0.483578496,0.017415798,0.643970436,,,
Arkansas County,Arkansas,05,001,5001,16773,8198,8575,16773,11816,4319,661,,0.70446551,0.257497168,0.039408573,,,
Ashley County,Arkansas,05,003,5003,18722,8864,9858,18722,13110,4606,1157,,0.7002457,0.246020724,0.061798953,,,
Baxter County,Arkansas,05,005,5005,42150,20534,21616,42150,39153,159,1157,,0.928896797,0.003772242,0.027449585,,,
Benton County,Arkansas,05,007,5007,294541,147765,146776,294541,194407,5357,53388,,0.660033747,0.018187621,0.181258297,,,
Boone County,Arkansas,05,009,5009,37896,18598,19298,37896,35722,103,1120,,0.942632468,0.002717965,0.02955457,,,
Bradley County,Arkansas,05,011,5011,10354,4934,5420,10354,6034,2735,1618,,0.582769944,0.264149121,0.156268109,,,
Calhoun County,Arkansas,05,013,5013,4717,2410,2307,4717,3725,581,544,,0.789696841,0.123171507,0.115327539,,,
Carroll County,Arkansas,05,015,5015,28526,14440,14086,28526,20888,54,4423,,0.732244268,0.00189301,0.155051532,,,
Chicot County,Arkansas,05,017,5017,9997,5073,4924,9997,4094,5338,628,,0.409522857,0.533960188,0.062818846,,,
Clark County,Arkansas,05,019,5019,21378,10201,11177,21378,14874,5076,1146,,0.695761998,0.237440359,0.053606511,,,
Clay County,Arkansas,05,021,5021,14399,7009,7390,14399,13539,13,120,,0.94027363,0.00090284,0.008333912,,,
Cleburne County,Arkansas,05,023,5023,25048,12514,12534,25048,23640,90,713,,0.943787927,0.003593101,0.028465347,,,
Cleveland County,Arkansas,05,025,5025,7491,3564,3927,7491,6282,984,23,,0.838606328,0.131357629,0.003070351,,,
Columbia County,Arkansas,05,027,5027,22527,10830,11697,22527,13785,7873,757,,0.611932348,0.349491721,0.03360412,,,
Conway County,Arkansas,05,029,5029,20872,10363,10509,20872,17124,2307,950,,0.820429283,0.110530855,0.045515523,,,
Craighead County,Arkansas,05,031,5031,112097,54657,57440,112097,82027,18803,6899,,0.731750181,0.167738655,0.061544912,,,
Crawford County,Arkansas,05,033,5033,60792,29978,30814,60792,50417,706,4950,,0.829336097,0.01161337,0.081425188,,,
Crittenden County,Arkansas,05,035,5035,47609,22528,25081,47609,19214,24013,1476,,0.403579155,0.504379424,0.031002542,,,
Cross County,Arkansas,05,037,5037,16681,8068,8613,16681,12009,3071,367,,0.719920868,0.184101673,0.022001079,,,
Dallas County,Arkansas,05,039,5039,6351,3189,3162,6351,3359,2779,92,,0.528893088,0.437568887,0.014485908,,,
Desha County,Arkansas,05,041,5041,11041,5251,5790,11041,4961,5371,765,,0.449325242,0.48645956,0.069287202,,,
Drew County,Arkansas,05,043,5043,17143,8345,8798,17143,11266,4580,706,,0.657177857,0.26716444,0.04118299,,,
Faulkner County,Arkansas,05,045,5045,126001,61429,64572,126001,100668,14961,6949,,0.79894604,0.118737153,0.055150356,,,
Franklin County,Arkansas,05,047,5047,17220,8561,8659,17220,14853,43,548,,0.862543554,0.002497096,0.031823461,,,
Fulton County,Arkansas,05,049,5049,12239,6008,6231,12239,11371,27,208,,0.929079173,0.002206063,0.016994853,,,
Garland County,Arkansas,05,051,5051,100062,48372,51690,100062,83604,7839,7179,,0.835521976,0.078341428,0.071745518,,,
Grant County,Arkansas,05,053,5053,18111,9117,8994,18111,16618,469,490,,0.917563911,0.025895864,0.027055381,,,
Greene County,Arkansas,05,055,5055,46182,22897,23285,46182,41655,1026,1678,,0.901974795,0.022216448,0.036334503,,,
Hempstead County,Arkansas,05,057,5057,19778,9449,10329,19778,10970,5878,2955,,0.554656689,0.297198908,0.149408434,,,
Hot Spring County,Arkansas,05,059,5059,33142,17331,15811,33142,27455,3823,1323,,0.828405045,0.115352121,0.039919136,,,
Howard County,Arkansas,05,061,5061,12701,6078,6623,12701,8176,2642,1559,,0.64372884,0.208015117,0.12274624,,,
Independence County,Arkansas,05,063,5063,38120,19047,19073,38120,32371,612,3313,,0.849186779,0.016054565,0.086909759,,,
Izard County,Arkansas,05,065,5065,13866,7311,6555,13866,12174,228,388,,0.877974903,0.016443098,0.027982115,,,
Jackson County,Arkansas,05,067,5067,16775,8428,8347,16775,12702,2468,515,,0.757198212,0.147123696,0.030700447,,,
Jefferson County,Arkansas,05,069,5069,65780,32789,32991,65780,24710,37023,1631,,0.375646093,0.562830648,0.02479477,,,
Johnson County,Arkansas,05,071,5071,25932,12847,13085,25932,21858,450,3539,,0.842896807,0.017353077,0.136472312,,,
Lafayette County,Arkansas,05,073,5073,6211,3198,3013,6211,3586,2226,49,,0.577362744,0.358396393,0.007889229,,,
Lawrence County,Arkansas,05,075,5075,16265,8028,8237,16265,15077,160,348,,0.926959729,0.009837073,0.021395635,,,
Lee County,Arkansas,05,077,5077,8511,4762,3749,8511,3401,4658,249,,0.399600517,0.54729174,0.029256257,,,
Lincoln County,Arkansas,05,079,5079,12966,8194,4772,12966,8046,3703,639,,0.620546043,0.28559309,0.049282739,,,
Little River County,Arkansas,05,081,5081,11959,5600,6359,11959,8723,2340,445,,0.729408813,0.195668534,0.037210469,,,
Logan County,Arkansas,05,083,5083,21240,10471,10769,21240,18959,363,707,,0.892608286,0.017090395,0.033286252,,,
Lonoke County,Arkansas,05,085,5085,74747,36944,37803,74747,64071,4136,3871,,0.857171525,0.055333324,0.051788032,,,
Madison County,Arkansas,05,087,5087,17032,8521,8511,17032,12687,33,1036,,0.744891968,0.001937529,0.060826679,,,
Marion County,Arkansas,05,089,5089,17076,8478,8598,17076,16056,32,446,,0.940267041,0.001873975,0.026118529,,,
Miller County,Arkansas,05,091,5091,42588,21239,21349,42588,28768,10934,1683,,0.675495445,0.256738988,0.039518174,,,
Mississippi County,Arkansas,05,093,5093,39749,19561,20188,39749,22846,13836,1861,,0.574756598,0.348084229,0.046818788,,,
Monroe County,Arkansas,05,095,5095,6681,3221,3460,6681,3570,2687,189,,0.534351145,0.402185302,0.028289178,,,
Montgomery County,Arkansas,05,097,5097,8571,4397,4174,8571,7797,76,410,,0.909695485,0.00886711,0.047835725,,,
Nevada County,Arkansas,05,099,5099,8228,4021,4207,8228,5340,2626,379,,0.649003403,0.319154108,0.046062227,,,
Newton County,Arkansas,05,101,5101,7175,3636,3539,7175,6718,11,123,,0.93630662,0.001533101,0.017142857,,,
Ouachita County,Arkansas,05,103,5103,22317,10761,11556,22317,12328,9146,562,,0.552403997,0.409822109,0.025182596,,,
Perry County,Arkansas,05,105,5105,10073,5120,4953,10073,9242,179,332,,0.917502234,0.017770277,0.032959396,,,
Phillips County,Arkansas,05,107,5107,15910,7420,8490,15910,5478,9777,305,,0.344311754,0.61451917,0.019170333,,,
Pike County,Arkansas,05,109,5109,10182,5010,5172,10182,8942,392,801,,0.87821646,0.038499313,0.078668238,,,
Poinsett County,Arkansas,05,111,5111,22740,11063,11677,22740,19300,1331,840,,0.848724714,0.058531223,0.036939314,,,
Polk County,Arkansas,05,113,5113,19348,9468,9880,19348,17304,18,1325,,0.894356006,0.000930329,0.06848253,,,
Pope County,Arkansas,05,115,5115,63830,31644,32186,63830,53984,1499,6783,,0.845746514,0.023484255,0.106266646,,,
Prairie County,Arkansas,05,117,5117,8162,4117,4045,8162,6910,857,179,,0.846606224,0.104998775,0.021930899,,,
Pulaski County,Arkansas,05,119,5119,398949,190897,208052,398949,202564,146981,32722,,0.507744098,0.368420525,0.082020509,,,
Randolph County,Arkansas,05,121,5121,18733,9404,9329,18733,16818,212,461,,0.897773982,0.011316927,0.024608979,,,
St. Francis County,Arkansas,05,123,5123,22740,12619,10121,22740,9350,12504,760,,0.411169745,0.549868074,0.033421284,,,
Saline County,Arkansas,05,125,5125,125724,61564,64160,125724,103194,10593,8776,,0.820797938,0.084255989,0.069803697,,,
Scott County,Arkansas,05,127,5127,9839,5192,4647,9839,8351,148,768,,0.848765118,0.015042179,0.078056713,,,
Searcy County,Arkansas,05,129,5129,7861,3941,3920,7861,6935,6,172,,0.882203282,0.000763262,0.021880168,,,
Sebastian County,Arkansas,05,131,5131,128448,63133,65315,128448,88914,7366,20023,,0.692217862,0.057346163,0.155884093,,,
Sevier County,Arkansas,05,133,5133,15797,7940,7857,15797,9277,790,5538,,0.587263404,0.050009495,0.350572894,,,
Sharp County,Arkansas,05,135,5135,17597,8641,8956,17597,16259,107,409,,0.923964312,0.006080582,0.023242598,,,
Stone County,Arkansas,05,137,5137,12474,6164,6310,12474,11305,13,266,,0.906285073,0.001042168,0.021324355,,,
Union County,Arkansas,05,139,5139,38368,18742,19626,38368,23789,12432,1751,,0.620021893,0.324020017,0.045636989,,,
Van Buren County,Arkansas,05,141,5141,15936,8001,7935,15936,14810,101,533,,0.929342369,0.006337851,0.033446285,,,
Washington County,Arkansas,05,143,5143,251863,126651,125212,251863,169308,8017,46214,,0.672222597,0.031830797,0.183488643,,,
White County,Arkansas,05,145,5145,77395,37828,39567,77395,67988,3410,3693,,0.878454681,0.044059694,0.047716261,,,
Woodruff County,Arkansas,05,147,5147,6157,3149,3008,6157,4289,1671,36,,0.69660549,0.271398408,0.005847003,,,
Yell County,Arkansas,05,149,5149,20195,10241,9954,20195,15971,349,4214,,0.790839317,0.017281505,0.208665511,,,
Alameda County,California,06,001,6001,1651949,819520,832429,1651949,528396,163859,385245,,0.319862175,0.099191319,0.233206352,,,
Alpine County,California,06,003,6003,1695,885,810,1695,1076,0,249,,0.63480826,0,0.146902655,,,
Amador County,California,06,005,6005,41029,22409,18620,41029,31903,825,6361,,0.777571961,0.020107729,0.155036681,,,
Butte County,California,06,007,6007,209470,104228,105242,209470,152117,3712,40829,,0.726199456,0.017720915,0.19491574,,,
Calaveras County,California,06,009,6009,45995,22864,23131,45995,37159,529,6403,,0.807892162,0.01150125,0.139210784,,,
Colusa County,California,06,011,6011,21895,11300,10595,21895,11210,311,13639,,0.511989039,0.014204156,0.622927609,,,
Contra Costa County,California,06,013,6013,1161458,571170,590288,1161458,505202,98346,316799,,0.43497225,0.084674607,0.272759755,,,
Del Norte County,California,06,015,6015,27293,14851,12442,27293,18316,805,5350,,0.671087825,0.029494742,0.196020958,,,
El Dorado County,California,06,017,6017,192299,96171,96128,192299,153632,1644,27230,,0.798922511,0.008549186,0.1416024,,,
Fresno County,California,06,019,6019,1012152,507316,504836,1012152,423296,44392,547669,,0.418213865,0.043859025,0.54109363,,,
Glenn County,California,06,021,6021,28623,14673,13950,28623,17120,158,12632,,0.598120393,0.005520036,0.441323411,,,
Humboldt County,California,06,023,6023,135418,67007,68411,135418,99692,1721,18744,,0.736179828,0.012708798,0.138415868,,,
Imperial County,California,06,025,6025,179319,92096,87223,179319,54559,4460,153460,,0.30425666,0.024871876,0.855793307,,,
Inyo County,California,06,027,6027,18803,9565,9238,18803,12154,182,4469,,0.646386215,0.009679306,0.237674839,,,
Kern County,California,06,029,6029,910433,463861,446572,910433,448046,46946,507456,,0.492124077,0.051564475,0.557378742,,,
Kings County,California,06,031,6031,152830,84389,68441,152830,70362,9782,87860,,0.460393902,0.064005758,0.574887129,,,
Lake County,California,06,033,6033,68139,34198,33941,68139,47171,1478,16184,,0.692276083,0.021690955,0.237514492,,,
Lassen County,California,06,035,6035,31177,19370,11807,31177,21468,2576,7027,,0.688584533,0.082625012,0.225390512,,,
Los Angeles County,California,06,037,6037,9848406,4879286,4969120,9848406,3489206,769139,4753369,,0.354291446,0.078097816,0.48265364,,,
Madera County,California,06,039,6039,158790,77958,80832,158790,70067,4089,95835,,0.441255747,0.025750992,0.603532968,,,
Marin County,California,06,041,6041,258765,127100,131665,258765,182267,6070,49128,,0.704372693,0.023457577,0.189855661,,,
Mariposa County,California,06,043,6043,17060,8788,8272,17060,13594,224,2341,,0.796834701,0.013130129,0.137221571,,,
Mendocino County,California,06,045,6045,90709,44983,45726,90709,61962,858,24440,,0.683085471,0.009458819,0.269433022,,,
Merced County,California,06,047,6047,285597,144886,140711,285597,102852,8250,178961,,0.360129833,0.028886858,0.626620728,,,
Modoc County,California,06,049,6049,8646,4246,4400,8646,6974,72,1321,,0.806615776,0.00832755,0.152787416,,,
Mono County,California,06,051,6051,13169,7360,5809,13169,9755,12,3513,,0.740754803,0.000911231,0.266762852,,,
Monterey County,California,06,053,6053,435834,221676,214158,435834,159097,9533,265748,,0.365040359,0.021873007,0.609745912,,,
Napa County,California,06,055,6055,136070,68093,67977,136070,81711,2625,48801,,0.600507092,0.019291541,0.358646285,,,
Nevada County,California,06,057,6057,102452,50594,51858,102452,87829,314,10723,,0.857269746,0.00306485,0.104663647,,,
Orange County,California,06,059,6059,3164063,1568200,1595863,3164063,1468454,51952,1080480,,0.464103907,0.016419395,0.341484983,,,
Placer County,California,06,061,6061,412435,202878,209557,412435,299005,6816,63412,,0.724974845,0.01652624,0.153750288,,,
Plumas County,California,06,063,6063,19607,9999,9608,19607,17071,266,1965,,0.870658438,0.013566583,0.100219309,,,
Riverside County,California,06,065,6065,2449909,1228321,1221588,2449909,1033132,158667,1239702,,0.421702194,0.064764446,0.506019611,,,
Sacramento County,California,06,067,6067,1584047,779834,804213,1584047,747022,150943,379734,,0.471590805,0.095289471,0.239723948,,,
San Benito County,California,06,069,6069,66056,33282,32774,66056,29824,683,40783,,0.451495701,0.010339712,0.617400388,,,
San Bernardino County,California,06,071,6071,2187816,1095613,1092203,2187816,855655,175250,1193691,,0.391100074,0.080102714,0.545608497,,,
San Diego County,California,06,073,6073,3282782,1660156,1622626,3282782,1740220,154596,1127221,,0.530105258,0.047092984,0.3433737,,,
San Francisco County,California,06,075,6075,836321,429837,406484,836321,338640,42547,133266,,0.404916294,0.050874007,0.159347906,,,
San Joaquin County,California,06,077,6077,787416,394479,392937,787416,292062,55048,332543,,0.370911945,0.069909679,0.422321873,,,
San Luis Obispo County,California,06,079,6079,281486,142085,139401,281486,203738,3189,68980,,0.723794434,0.01132916,0.245056593,,,
San Mateo County,California,06,081,6081,745100,371214,373886,745100,303184,16534,185378,,0.406903771,0.02219031,0.248796135,,,
Santa Barbara County,California,06,083,6083,443975,222679,221296,443975,240915,7468,211412,,0.542631905,0.016820767,0.476179965,,,
Santa Clara County,California,06,085,6085,1903297,970000,933297,1903297,631965,45325,477632,,0.332036986,0.02381394,0.250949799,,,
Santa Cruz County,California,06,087,6087,266021,132752,133269,266021,167132,2545,93116,,0.62826619,0.009566914,0.350032516,,,
Shasta County,California,06,089,6089,181554,89611,91943,181554,145566,1614,20604,,0.801777983,0.008889917,0.113486896,,,
Sierra County,California,06,091,6091,2731,1351,1380,2731,2469,8,262,,0.904064445,0.00292933,0.095935555,,,
Siskiyou County,California,06,093,6093,43834,21900,21934,43834,34820,736,5757,,0.794360542,0.016790619,0.131336406,,,
Solano County,California,06,095,6095,450824,224744,226080,450824,192705,58103,130628,,0.427450624,0.128881781,0.289753873,,,
Sonoma County,California,06,097,6097,485642,238817,246825,485642,313481,7546,142986,,0.645498124,0.015538195,0.294426759,,,
Stanislaus County,California,06,099,6099,552250,275215,277035,552250,276614,15674,271787,,0.500885469,0.028382073,0.492144862,,,
Sutter County,California,06,101,6101,98971,49693,49278,98971,49812,1714,32061,,0.503298946,0.017318204,0.323943377,,,
Tehama County,California,06,103,6103,65520,32682,32838,65520,45414,571,18458,,0.693131868,0.008714896,0.281715507,,,
Trinity County,California,06,105,6105,15886,7776,8110,15886,12782,147,936,,0.804607831,0.009253431,0.058919804,,,
Tulare County,California,06,107,6107,475774,238478,237296,475774,202844,7136,314250,,0.426345282,0.014998718,0.660502676,,,
Tuolumne County,California,06,109,6109,54873,28254,26619,54873,45309,950,7250,,0.825706632,0.017312704,0.132123266,,,
Ventura County,California,06,111,6111,838259,416981,421278,838259,491174,15452,367516,,0.585945394,0.018433444,0.438427741,,,
Yolo County,California,06,113,6113,217782,106025,111757,217782,119349,5876,72347,,0.548020498,0.02698111,0.332199172,,,
Yuba County,California,06,115,6115,83079,42183,40896,83079,50228,3075,24887,,0.604581182,0.037012964,0.299558252,,,
Adams County,Colorado,08,001,8001,524408,266432,257976,524408,315627,18265,221633,,0.601872969,0.034829751,0.422634666,,,
Alamosa County,Colorado,08,003,8003,16515,8153,8362,16515,10176,304,7900,,0.616167121,0.018407508,0.478353012,,,
Arapahoe County,Colorado,08,005,8005,655709,327215,328494,655709,405690,71075,138906,,0.618704334,0.10839412,0.211840923,,,
Archuleta County,Colorado,08,007,8007,13730,6867,6863,13730,11039,2,2255,,0.804005827,0.000145666,0.164238893,,,
Baca County,Colorado,08,009,8009,3460,1732,1728,3460,3112,11,370,,0.899421965,0.003179191,0.106936416,,,
Bent County,Colorado,08,011,8011,5524,3435,2089,5524,3876,192,1780,,0.70166546,0.034757422,0.322230268,,,
Boulder County,Colorado,08,013,8013,328317,165677,162640,328317,264800,2745,47948,,0.806537584,0.008360822,0.146041783,,,
Broomfield County,Colorado,08,014,8014,75110,37818,37292,75110,59246,958,10381,,0.788789775,0.012754627,0.138210624,,,
Chaffee County,Colorado,08,015,8015,19876,10404,9472,19876,17640,218,1933,,0.887502516,0.010968002,0.097252968,,,
Cheyenne County,Colorado,08,017,8017,1732,892,840,1732,1445,19,219,,0.834295612,0.010969977,0.126443418,,,
Clear Creek County,Colorado,08,019,8019,9358,4833,4525,9358,8307,130,708,,0.887689677,0.013891857,0.075657192,,,
Conejos County,Colorado,08,021,8021,7536,3783,3753,7536,4624,12,3773,,0.61358811,0.001592357,0.500663482,,,
Costilla County,Colorado,08,023,8023,3571,1801,1770,3571,1870,125,1985,,0.52366284,0.035004201,0.555866704,,,
Crowley County,Colorado,08,025,8025,5734,3983,1751,5734,3839,342,1644,,0.669515173,0.059644227,0.286710848,,,
Custer County,Colorado,08,027,8027,5073,2559,2514,5073,4757,0,92,,0.937709442,0,0.018135226,,,
Delta County,Colorado,08,029,8029,31353,15587,15766,31353,27196,252,4460,,0.867413007,0.008037508,0.14225114,,,
Denver County,Colorado,08,031,8031,713734,359969,353765,713734,448646,62785,199425,,0.628589923,0.087966946,0.279410817,,,
Dolores County,Colorado,08,033,8033,2385,1283,1102,2385,1896,0,296,,0.794968553,0,0.124109015,,,
Douglas County,Colorado,08,035,8035,368283,185382,182901,368283,301035,5286,36431,,0.817401292,0.014353093,0.09892121,,,
Eagle County,Colorado,08,037,8037,55374,29813,25561,55374,39892,524,16729,,0.720410301,0.009462925,0.302109293,,,
Elbert County,Colorado,08,039,8039,27152,13826,13326,27152,23278,144,2337,,0.857321744,0.005303477,0.086071008,,,
El Paso County,Colorado,08,041,8041,736008,374135,361873,736008,534679,43788,134942,,0.726458136,0.059493919,0.183343116,,,
Fremont County,Colorado,08,043,8043,49394,28719,20675,49394,42860,1860,6399,,0.867716727,0.037656396,0.129550148,,,
Garfield County,Colorado,08,045,8045,62034,31881,30153,62034,44951,355,19867,,0.724618757,0.005722668,0.320259857,,,
Gilpin County,Colorado,08,047,8047,5877,3220,2657,5877,5198,65,413,,0.884464863,0.011060065,0.070273949,,,
Grand County,Colorado,08,049,8049,15794,8089,7705,15794,12825,57,1573,,0.812017222,0.003608965,0.099594783,,,
Gunnison County,Colorado,08,051,8051,17158,9409,7749,17158,15373,181,1691,,0.895966896,0.010549015,0.09855461,,,
Hinsdale County,Colorado,08,053,8053,939,465,474,939,816,19,29,,0.869009585,0.020234292,0.030883919,,,
Huerfano County,Colorado,08,055,8055,6946,3718,3228,6946,5912,0,2141,,0.851137345,0,0.308234955,,,
Jackson County,Colorado,08,057,8057,1422,770,652,1422,1275,15,189,,0.896624473,0.010548523,0.132911392,,,
Jefferson County,Colorado,08,059,8059,579715,291622,288093,579715,475142,6578,92162,,0.819613086,0.011346955,0.158978119,,,
Kiowa County,Colorado,08,061,8061,1356,641,715,1356,1264,0,133,,0.932153392,0,0.098082596,,,
Kit Carson County,Colorado,08,063,8063,7015,3549,3466,7015,5656,4,1383,,0.806272274,0.000570207,0.197148967,,,
Lake County,Colorado,08,065,8065,7411,3770,3641,7411,5016,7,2606,,0.676831737,0.000944542,0.351639455,,,
La Plata County,Colorado,08,067,8067,56088,28387,27701,56088,46757,106,7149,,0.833636428,0.001889887,0.127460419,,,
Larimer County,Colorado,08,069,8069,363561,181725,181836,363561,305591,3680,46167,,0.840549454,0.010122098,0.126985568,,,
Las Animas County,Colorado,08,071,8071,14392,7583,6809,14392,10286,248,5614,,0.714702613,0.017231795,0.390077821,,,
Lincoln County,Colorado,08,073,8073,5561,3283,2278,5561,4647,315,827,,0.835641072,0.056644488,0.14871426,,,
Logan County,Colorado,08,075,8075,21067,11433,9634,21067,17453,334,3530,,0.828452081,0.01585418,0.16756064,,,
Mesa County,Colorado,08,077,8077,157316,77965,79351,157316,133317,908,23957,,0.847447176,0.005771822,0.152285845,,,
Mineral County,Colorado,08,079,8079,799,406,393,799,726,0,19,,0.908635795,0,0.023779725,,,
Moffat County,Colorado,08,081,8081,13258,6750,6508,13258,11286,17,2178,,0.851259617,0.001282245,0.164278172,,,
Montezuma County,Colorado,08,083,8083,26204,13141,13063,26204,20389,321,3243,,0.778087315,0.012250038,0.123759731,,,
Montrose County,Colorado,08,085,8085,43272,21611,21661,43272,35209,147,9195,,0.813667036,0.003397116,0.212493067,,,
Morgan County,Colorado,08,087,8087,29186,15054,14132,29186,20540,894,10918,,0.703762078,0.030631125,0.374083465,,,
Otero County,Colorado,08,089,8089,18460,9179,9281,18460,13104,188,7698,,0.709859155,0.010184182,0.417009751,,,
Ouray County,Colorado,08,091,8091,5024,2600,2424,5024,4519,101,238,,0.899482484,0.020103503,0.047372611,,,
Park County,Colorado,08,093,8093,17739,9332,8407,17739,16109,143,1315,,0.908112069,0.008061334,0.074130447,,,
Phillips County,Colorado,08,095,8095,4491,2162,2329,4491,3671,0,1214,,0.817412603,0,0.270318415,,,
Pitkin County,Colorado,08,097,8097,17119,8876,8243,17119,14760,80,1904,,0.862199895,0.00467317,0.11122145,,,
Prowers County,Colorado,08,099,8099,11931,5977,5954,11931,8397,84,4750,,0.703796832,0.007040483,0.398122538,,,
Pueblo County,Colorado,08,101,8101,168726,83770,84956,168726,125637,3510,70812,,0.744621457,0.020802959,0.419686355,,,
Rio Blanco County,Colorado,08,103,8103,6518,3426,3092,6518,5570,6,685,,0.854556612,0.000920528,0.105093587,,,
Rio Grande County,Colorado,08,105,8105,11394,5763,5631,11394,8488,50,4630,,0.744953484,0.004388275,0.406354222,,,
Routt County,Colorado,08,107,8107,24990,13106,11884,24990,21236,52,2180,,0.849779912,0.002080832,0.087234894,,,
Saguache County,Colorado,08,109,8109,6511,3336,3175,6511,4983,48,2404,,0.765320227,0.007372139,0.369221318,,,
San Juan County,Colorado,08,111,8111,690,378,312,690,604,0,112,,0.875362319,0,0.162318841,,,
San Miguel County,Colorado,08,113,8113,8026,4592,3434,8026,7191,56,906,,0.89596312,0.006977324,0.11288313,,,
Sedgwick County,Colorado,08,115,8115,2346,1190,1156,2346,1990,21,437,,0.848252344,0.008951407,0.18627451,,,
Summit County,Colorado,08,117,8117,30857,16896,13961,30857,24521,115,5218,,0.794665716,0.003726869,0.169102635,,,
Teller County,Colorado,08,119,8119,24774,12664,12110,24774,21685,236,1831,,0.875312828,0.009526116,0.073908129,,,
Washington County,Colorado,08,121,8121,4839,2537,2302,4839,4286,58,548,,0.88572019,0.011985948,0.113246539,,,
Weld County,Colorado,08,123,8123,340711,172951,167760,340711,258936,4937,103804,,0.759987203,0.014490286,0.304668766,,,
Yuma County,Colorado,08,125,8125,9921,5063,4858,9921,7938,12,2862,,0.800120956,0.001209555,0.288478984,,,
Capitol Planning Region,Connecticut,09,110,9110,969029,474604,494425,969029,637789,120661,168439,,0.658173285,0.124517429,0.173822455,,,
Greater Bridgeport Planning Region,Connecticut,09,120,9120,326296,160029,166267,326296,192722,41040,85034,,0.590635497,0.12577537,0.260603869,,,
Lower Connecticut River Valley Planning Region,Connecticut,09,130,9130,174983,86295,88688,174983,143620,8921,13031,,0.820765446,0.050982095,0.074470091,,,
Naugatuck Valley Planning Region,Connecticut,09,140,9140,452303,221077,231226,452303,302936,50684,86804,,0.669763411,0.112057625,0.191915596,,,
Northeastern Connecticut Planning Region,Connecticut,09,150,9150,95829,47829,48000,95829,84910,1722,4839,,0.886057457,0.017969508,0.050496196,,,
Northwest Hills Planning Region,Connecticut,09,160,9160,112848,56408,56440,112848,96043,3072,9442,,0.851082873,0.027222459,0.083670069,,,
South Central Connecticut Planning Region,Connecticut,09,170,9170,566803,273939,292864,566803,362498,79175,108273,,0.639548485,0.139686981,0.191024042,,,
Southeastern Connecticut Planning Region,Connecticut,09,180,9180,279025,139744,139281,279025,212725,15293,40941,,0.762386883,0.054808709,0.146728788,,,
Western Connecticut Planning Region,Connecticut,09,190,9190,621232,305192,316040,621232,398099,64185,123865,,0.640821786,0.103318889,0.199386059,,,
Kent County,Delaware,10,001,10001,185043,89146,95897,185043,110861,49879,14649,,0.599109396,0.269553563,0.079165383,,,
New Castle County,Delaware,10,003,10003,573030,278119,294911,573030,323642,144850,65392,,0.564790674,0.252779087,0.114116189,,,
Sussex County,Delaware,10,005,10005,247799,120320,127479,247799,187296,25916,27788,,0.755838401,0.104584764,0.112139274,,,
District of Columbia,District of Columbia,11,001,11001,672079,320001,352078,672079,262549,290772,77760,,0.390651992,0.432645567,0.115700684,,,
Alachua County,Florida,12,001,12001,281751,135748,146003,281751,176610,54537,34392,,0.626830073,0.19356453,0.122065228,,,
Baker County,Florida,12,003,12003,28186,14848,13338,28186,22038,3288,1049,,0.781877528,0.116653658,0.037217058,,,
Bay County,Florida,12,005,12005,181368,90134,91234,181368,138770,18134,15221,,0.765129461,0.099984562,0.083923294,,,
Bradford County,Florida,12,007,12007,27888,15181,12707,27888,20612,5182,1360,,0.739099254,0.185814687,0.048766495,,,
Brevard County,Florida,12,009,12009,620533,305646,314887,620533,467703,60843,72613,,0.753711728,0.09804958,0.117017145,,,
Broward County,Florida,12,011,12011,1946127,954117,992010,1946127,829741,549799,621023,,0.426355012,0.282509312,0.319107129,,,
Calhoun County,Florida,12,013,12013,13593,7619,5974,13593,10412,1578,685,,0.765982491,0.116089164,0.050393585,,,
Charlotte County,Florida,12,015,12015,195083,95972,99111,195083,165176,10312,15278,,0.846696022,0.052859552,0.078315384,,,
Citrus County,Florida,12,017,12017,158693,77744,80949,158693,140889,3546,10329,,0.887808536,0.022345031,0.065087937,,,
Clay County,Florida,12,019,12019,223436,110382,113054,223436,160668,25437,24684,,0.719078394,0.11384468,0.110474588,,,
Collier County,Florida,12,021,12021,387681,191331,196350,387681,269331,25539,106446,,0.694723239,0.065876326,0.274571104,,,
Columbia County,Florida,12,023,12023,70755,36505,34250,70755,51524,11658,5258,,0.728202954,0.164765741,0.074312769,,,
DeSoto County,Florida,12,027,12027,34719,19099,15620,34719,23502,4463,10334,,0.676920418,0.128546329,0.297646822,,,
Dixie County,Florida,12,029,12029,16952,9312,7640,16952,14427,1119,759,,0.851050024,0.06600991,0.044773478,,,
Duval County,Florida,12,031,12031,1007189,488813,518376,1007189,531480,291322,118365,,0.527686462,0.289242635,0.117520148,,,
Escambia County,Florida,12,033,12033,323275,159462,163813,323275,208075,68374,21413,,0.64364705,0.211504137,0.066237723,,,
Flagler County,Florida,12,035,12035,121710,58808,62902,121710,93957,11420,13595,,0.771974365,0.093829595,0.111699942,,,
Franklin County,Florida,12,037,12037,12418,6924,5494,12418,9934,1355,675,,0.799967789,0.1091158,0.054356579,,,
Gadsden County,Florida,12,039,12039,43642,20907,22735,43642,14775,24028,5180,,0.338550021,0.550570551,0.118693002,,,
Gilchrist County,Florida,12,041,12041,18494,9599,8895,18494,16476,592,1378,,0.89088353,0.032010382,0.074510652,,,
Glades County,Florida,12,043,12043,12324,6955,5369,12324,7927,1862,3089,,0.643216488,0.151087309,0.25064914,,,
Gulf County,Florida,12,045,12045,14772,8477,6295,14772,11680,2075,656,,0.79068508,0.140468454,0.04440834,,,
Hamilton County,Florida,12,047,12047,13445,7473,5972,13445,7889,4327,1478,,0.586760878,0.321829676,0.109929342,,,
Hardee County,Florida,12,049,12049,25508,13783,11725,25508,15664,1666,10713,,0.614081857,0.065312843,0.419985887,,,
Hendry County,Florida,12,051,12051,40798,22360,18438,40798,22532,4394,23074,,0.552281975,0.107701358,0.56556694,,,
Hernando County,Florida,12,053,12053,201512,97885,103627,201512,158608,10078,32348,,0.787089603,0.05001191,0.16052642,,,
Highlands County,Florida,12,055,12055,103808,50834,52974,103808,75374,9763,22310,,0.726090475,0.094048628,0.214915999,,,
Hillsborough County,Florida,12,057,12057,1489634,733382,756252,1489634,816520,244347,441871,,0.548134642,0.164031567,0.296630582,,,
Holmes County,Florida,12,059,12059,19626,10452,9174,19626,16650,1310,697,,0.848364415,0.066748191,0.035514114,,,
Indian River County,Florida,12,061,12061,163856,79409,84447,163856,126618,13211,22009,,0.772739479,0.080625671,0.134319158,,,
Jackson County,Florida,12,063,12063,47652,25789,21863,47652,31746,12107,2432,,0.666204986,0.254071183,0.051036683,,,
Jefferson County,Florida,12,065,12065,14713,7680,7033,14713,9238,4434,704,,0.627880106,0.301366139,0.047848841,,,
Lafayette County,Florida,12,067,12067,8035,4742,3293,8035,6169,1419,956,,0.767766024,0.176602365,0.118979465,,,
Lake County,Florida,12,069,12069,398696,194084,204612,398696,281556,40334,71545,,0.706192187,0.101164797,0.179447499,,,
Lee County,Florida,12,071,12071,792692,389853,402839,792692,558482,63125,187055,,0.704538459,0.079633704,0.235974376,,,
Leon County,Florida,12,073,12073,295335,139811,155524,295335,166854,90582,23394,,0.564965209,0.30670933,0.079211743,,,
Levy County,Florida,12,075,12075,44276,21641,22635,44276,36408,3705,4365,,0.822296504,0.083679646,0.098586141,,,
Liberty County,Florida,12,077,12077,7650,4338,3312,7650,5914,1004,544,,0.773071895,0.13124183,0.071111111,,,
Madison County,Florida,12,079,12079,18113,9535,8578,18113,10161,6604,1005,,0.560978303,0.364600011,0.055485011,,,
Manatee County,Florida,12,081,12081,416020,201855,214165,416020,310362,32970,74279,,0.746026633,0.079250998,0.178546704,,,
Marion County,Florida,12,083,12083,387697,187158,200539,387697,278140,48781,61736,,0.71741592,0.125822485,0.159237755,,,
Martin County,Florida,12,085,12085,160464,79428,81036,160464,129803,8071,24690,,0.808922874,0.050297886,0.153866288,,,
Miami-Dade County,Florida,12,086,12086,2685296,1315940,1369356,2685296,990981,414760,1846781,,0.369039763,0.154455971,0.687738335,,,
Monroe County,Florida,12,087,12087,81840,42374,39466,81840,59390,6070,19611,,0.725684262,0.07416911,0.2396261,,,
Nassau County,Florida,12,089,12089,94653,46910,47743,94653,81326,5250,5052,,0.859201504,0.055465754,0.053373903,,,
Okaloosa County,Florida,12,091,12091,214281,108812,105469,214281,156300,20037,23230,,0.729416047,0.093508057,0.108409052,,,
Okeechobee County,Florida,12,093,12093,40249,21715,18534,40249,29240,3262,10281,,0.726477676,0.081045492,0.255434918,,,
Orange County,Florida,12,095,12095,1440471,709185,731286,1440471,671615,292616,478735,,0.466246804,0.203139112,0.332346156,,,
Osceola County,Florida,12,097,12097,406943,201879,205064,406943,176679,44788,223890,,0.434161541,0.11005964,0.550175332,,,
Palm Beach County,Florida,12,099,12099,1507453,735143,772310,1507453,864974,278621,358640,,0.573798321,0.18482898,0.237911232,,,
Pasco County,Florida,12,101,12101,588758,288052,300706,588758,442068,36208,104251,,0.750848396,0.061498952,0.177069356,,,
Pinellas County,Florida,12,103,12103,960565,463819,496746,960565,721059,93311,104765,,0.75066133,0.097141786,0.109066018,,,
Polk County,Florida,12,105,12105,760961,375103,385858,760961,455386,112450,211002,,0.598435399,0.14777367,0.277283593,,,
Putnam County,Florida,12,107,12107,74235,36739,37496,74235,54226,11347,8092,,0.730464067,0.152852428,0.109005186,,,
St. Johns County,Florida,12,109,12109,292243,143066,149177,292243,237204,15285,25354,,0.811667003,0.052302365,0.086756569,,,
St. Lucie County,Florida,12,111,12111,346237,170025,176212,346237,206941,72630,72914,,0.597685978,0.209769609,0.210589856,,,
Santa Rosa County,Florida,12,113,12113,193719,99106,94613,193719,157431,10729,12751,,0.812677125,0.055384345,0.065822144,,,
Sarasota County,Florida,12,115,12115,449011,215219,233792,449011,377207,18450,45922,,0.840084096,0.041090307,0.102273664,,,
Seminole County,Florida,12,117,12117,474912,231116,243796,474912,297613,56652,110154,,0.626669783,0.119289468,0.231946129,,,
Sumter County,Florida,12,119,12119,137536,68265,69271,137536,118694,9405,8369,,0.863003141,0.068382096,0.060849523,,,
Suwannee County,Florida,12,121,12121,44484,23308,21176,44484,34244,4431,5040,,0.769804874,0.099608848,0.113299164,,,
Taylor County,Florida,12,123,12123,21422,11646,9776,21422,15708,4296,879,,0.733264868,0.200541499,0.041032583,,,
Union County,Florida,12,125,12125,15551,10023,5528,15551,11388,2518,799,,0.732300174,0.161918848,0.051379333,,,
Volusia County,Florida,12,127,12127,568229,278353,289876,568229,412706,60661,89077,,0.726302248,0.106754495,0.156762502,,,
Wakulla County,Florida,12,129,12129,34608,18878,15730,34608,27006,4799,1625,,0.780339806,0.13866736,0.046954461,,,
Walton County,Florida,12,131,12131,79846,40593,39253,79846,67211,3070,6563,,0.841757884,0.038449014,0.082195727,,,
Washington County,Florida,12,133,12133,25259,13276,11983,25259,19709,3428,973,,0.780276337,0.135714003,0.038520923,,,
Appling County,Georgia,13,001,13001,18426,9253,9173,18426,12862,3265,1909,,0.698035385,0.177195268,0.103603604,,,
Atkinson County,Georgia,13,003,13003,8261,4010,4251,8261,5296,1255,2177,,0.641084614,0.151918654,0.263527418,,,
Bacon County,Georgia,13,005,13005,11129,5461,5668,11129,8227,1671,929,,0.739239824,0.150148261,0.083475604,,,
Baker County,Georgia,13,007,13007,2830,1359,1471,2830,1388,1151,73,,0.490459364,0.406713781,0.025795053,,,
Baldwin County,Georgia,13,009,13009,43669,21976,21693,43669,22907,18234,1206,,0.524559756,0.417550207,0.027616845,,,
Banks County,Georgia,13,011,13011,18757,9406,9351,18757,16320,315,1299,,0.870075172,0.01679373,0.069254145,,,
Barrow County,Georgia,13,013,13013,86982,42933,44049,86982,60244,11489,12347,,0.692603067,0.132084799,0.141948909,,,
Bartow County,Georgia,13,015,13015,111153,55315,55838,111153,86925,12224,11401,,0.782030175,0.10997454,0.102570331,,,
Ben Hill County,Georgia,13,017,13017,17138,7897,9241,17138,9823,6468,1108,,0.573170732,0.377406932,0.064651651,,,
Berrien County,Georgia,13,019,13019,18257,9175,9082,18257,14839,1929,1079,,0.812784138,0.105658104,0.059100619,,,
Bibb County,Georgia,13,021,13021,156543,73767,82776,156543,56414,85362,6967,,0.360373827,0.545294264,0.044505344,,,
Bleckley County,Georgia,13,023,13023,12414,6138,6276,12414,8557,3232,464,,0.689302401,0.260351216,0.037377155,,,
Brantley County,Georgia,13,025,13025,18171,8963,9208,18171,16795,535,378,,0.924274944,0.029442518,0.020802377,,,
Brooks County,Georgia,13,027,13027,16285,7654,8631,16285,9343,5658,1048,,0.573718146,0.347436291,0.0643537,,,
Bryan County,Georgia,13,029,13029,46681,23289,23392,46681,33744,6530,3672,,0.722863692,0.139885607,0.078661554,,,
Bulloch County,Georgia,13,031,13031,81372,39493,41879,81372,51083,23003,4105,,0.627771224,0.282689377,0.050447328,,,
Burke County,Georgia,13,033,13033,24427,11976,12451,24427,12243,11061,841,,0.50120768,0.452818602,0.034429115,,,
Butts County,Georgia,13,035,13035,26074,13997,12077,26074,17091,7204,941,,0.655480555,0.276290558,0.036089591,,,
Calhoun County,Georgia,13,037,13037,5528,3416,2112,5528,1878,3293,267,,0.339725036,0.595694645,0.048299566,,,
Camden County,Georgia,13,039,13039,56036,29109,26927,56036,39604,10174,4106,,0.70675994,0.181561853,0.073274324,,,
Candler County,Georgia,13,043,13043,10972,5359,5613,10972,6658,2485,1398,,0.606817353,0.2264856,0.127415239,,,
Carroll County,Georgia,13,045,13045,122187,59532,62655,122187,85305,25063,10112,,0.698151194,0.205120021,0.082758395,,,
Catoosa County,Georgia,13,047,13047,68356,33477,34879,68356,60908,1557,2595,,0.891041021,0.02277781,0.037963017,,,
Charlton County,Georgia,13,049,13049,12711,7370,5341,12711,7228,3183,1967,,0.568641334,0.250413028,0.154747856,,,
Chatham County,Georgia,13,051,13051,298143,143462,154681,298143,142225,117507,23945,,0.477036187,0.394129663,0.080313809,,,
Chattahoochee County,Georgia,13,053,13053,9181,6131,3050,9181,5430,1702,1600,,0.591438841,0.185382856,0.174272955,,,
Chattooga County,Georgia,13,055,13055,24975,12900,12075,24975,20514,2381,1361,,0.821381381,0.095335335,0.054494494,,,
Cherokee County,Georgia,13,057,13057,274539,135925,138614,274539,214561,19719,33341,,0.78153195,0.071825861,0.121443584,,,
Clarke County,Georgia,13,059,13059,129267,61287,67980,129267,74568,33970,14751,,0.576852561,0.26278942,0.114112651,,,
Clay County,Georgia,13,061,13061,2853,1286,1567,2853,1135,1698,4,,0.397826849,0.595162986,0.001402033,,,
Clayton County,Georgia,13,063,13063,298771,140357,158414,298771,34422,208577,42738,,0.115211985,0.698116618,0.143046012,,,
Clinch County,Georgia,13,065,13065,6722,3378,3344,6722,4387,1718,377,,0.652633145,0.255578697,0.056084499,,,
Cobb County,Georgia,13,067,13067,769152,374768,394384,769152,388587,207606,112882,,0.505214834,0.269915439,0.146761628,,,
Coffee County,Georgia,13,069,13069,43161,22200,20961,43161,26205,12126,5576,,0.60714534,0.280948078,0.129190705,,,
Colquitt County,Georgia,13,071,13071,45907,22989,22918,45907,26313,10472,9066,,0.573180561,0.22811336,0.197486222,,,
Columbia County,Georgia,13,073,13073,159638,78103,81535,159638,107888,28671,12474,,0.675829063,0.179600095,0.07813929,,,
Cook County,Georgia,13,075,13075,17363,8537,8826,17363,11340,4840,1216,,0.653112941,0.278753672,0.07003398,,,
Coweta County,Georgia,13,077,13077,150071,73136,76935,150071,107104,27786,11859,,0.713688854,0.185152361,0.079022596,,,
Crawford County,Georgia,13,079,13079,12183,6311,5872,12183,8940,2620,466,,0.733809407,0.215053763,0.038250021,,,
Crisp County,Georgia,13,081,13081,19995,9734,10261,19995,10174,8999,690,,0.508827207,0.450062516,0.034508627,,,
Dade County,Georgia,13,083,13083,16196,8186,8010,16196,14915,260,374,,0.920906397,0.016053347,0.023092122,,,
Dawson County,Georgia,13,085,13085,28704,14652,14052,28704,25512,462,1926,,0.888795987,0.016095318,0.067098662,,,
Decatur County,Georgia,13,087,13087,29118,14048,15070,29118,14565,12234,1972,,0.500206058,0.420152483,0.067724432,,,
DeKalb County,Georgia,13,089,13089,762105,361840,400265,762105,229260,392153,79372,,0.30082469,0.514565578,0.104148379,,,
Dodge County,Georgia,13,091,13091,19909,10510,9399,19909,13085,6133,680,,0.657240444,0.308051635,0.034155407,,,
Dooly County,Georgia,13,093,13093,11026,6075,4951,11026,4606,5283,845,,0.417739888,0.479140214,0.07663704,,,
Dougherty County,Georgia,13,095,13095,83915,38524,45391,83915,20016,59207,2561,,0.238527081,0.705559197,0.030518978,,,
Douglas County,Georgia,13,097,13097,146141,69709,76432,146141,53260,71864,17076,,0.364442559,0.491744274,0.11684606,,,
Early County,Georgia,13,099,13099,10683,5067,5616,10683,4628,5541,225,,0.433211645,0.51867453,0.0210615,,,
Echols County,Georgia,13,101,13101,3705,1687,2018,3705,2504,157,1012,,0.675843455,0.042375169,0.273144399,,,
Effingham County,Georgia,13,103,13103,67265,33309,33956,67265,51410,9612,4128,,0.764290493,0.142897495,0.061369211,,,
Elbert County,Georgia,13,105,13105,19725,9327,10398,19725,12787,5065,1110,,0.648263625,0.256780735,0.056273764,,,
Emanuel County,Georgia,13,107,13107,22961,11542,11419,22961,13705,7448,1067,,0.596881669,0.324376116,0.046470101,,,
Evans County,Georgia,13,109,13109,10740,5122,5618,10740,5940,2935,1296,,0.553072626,0.273277467,0.120670391,,,
Fannin County,Georgia,13,111,13111,25605,12584,13021,25605,23885,182,794,,0.93282562,0.007107987,0.031009568,,,
Fayette County,Georgia,13,113,13113,120689,58636,62053,120689,71231,30813,9978,,0.590202918,0.2553091,0.082675306,,,
Floyd County,Georgia,13,115,13115,98985,48437,50548,98985,71966,13550,11878,,0.72703945,0.136889428,0.119997979,,,
Forsyth County,Georgia,13,117,13117,260062,130001,130061,260062,172382,10689,26070,,0.662849628,0.041101737,0.100245326,,,
Franklin County,Georgia,13,119,13119,23840,11777,12063,23840,19662,1996,1244,,0.824748322,0.083724832,0.052181208,,,
Fulton County,Georgia,13,121,13121,1068507,519761,548746,1068507,420487,460766,86110,,0.393527604,0.431224129,0.080589084,,,
Gilmer County,Georgia,13,123,13123,31976,16032,15944,31976,28082,241,3839,,0.878221166,0.007536903,0.120058794,,,
Glascock County,Georgia,13,125,13125,2913,1292,1621,2913,2530,343,21,,0.868520426,0.117748026,0.007209063,,,
Glynn County,Georgia,13,127,13127,84987,39828,45159,84987,54868,20918,6400,,0.645604622,0.246131761,0.075305635,,,
Gordon County,Georgia,13,129,13129,58336,29004,29332,58336,47200,2160,9371,,0.809105869,0.037026879,0.160638371,,,
Grady County,Georgia,13,131,13131,26056,12684,13372,26056,15828,7847,3366,,0.607460854,0.301159042,0.129183298,,,
Greene County,Georgia,13,133,13133,19586,9835,9751,19586,11744,6012,1360,,0.599611968,0.306953947,0.069437353,,,
Gwinnett County,Georgia,13,135,13135,966972,474165,492807,966972,348931,274987,224818,,0.360849125,0.284379486,0.232496908,,,
Habersham County,Georgia,13,137,13137,46948,22325,24623,46948,37247,1602,7315,,0.79336713,0.034122859,0.155810684,,,
Hall County,Georgia,13,139,13139,208395,103975,104420,208395,140452,14159,59586,,0.673970105,0.067943089,0.285928165,,,
Hancock County,Georgia,13,141,13141,8630,4566,4064,8630,2280,6161,55,,0.26419467,0.713904983,0.006373117,,,
Haralson County,Georgia,13,143,13143,30720,15146,15574,30720,27822,1458,589,,0.905664063,0.047460938,0.019173177,,,
Harris County,Georgia,13,145,13145,35509,18057,17452,35509,27098,5609,1657,,0.763130474,0.157959954,0.046664226,,,
Hart County,Georgia,13,147,13147,26484,13174,13310,26484,19848,4548,1050,,0.74943362,0.171726325,0.039646579,,,
Heard County,Georgia,13,149,13149,11616,5754,5862,11616,9884,919,302,,0.850895317,0.079115014,0.025998623,,,
Henry County,Georgia,13,151,13151,245417,116703,128714,245417,90157,124604,19620,,0.367362489,0.507723589,0.079945562,,,
Houston County,Georgia,13,153,13153,166902,81132,85770,166902,91775,52733,12228,,0.549873579,0.315951876,0.07326455,,,
Irwin County,Georgia,13,155,13155,9385,4832,4553,9385,6382,2375,658,,0.680021311,0.253063399,0.070111881,,,
Jackson County,Georgia,13,157,13157,80640,40190,40450,80640,64323,6222,7989,,0.79765625,0.077157738,0.09906994,,,
Jasper County,Georgia,13,159,13159,15345,7512,7833,15345,11481,2627,739,,0.748191593,0.171195829,0.048159009,,,
Jeff Davis County,Georgia,13,161,13161,14838,7633,7205,14838,10476,2056,2033,,0.706025071,0.138563149,0.137013075,,,
Jefferson County,Georgia,13,163,13163,15468,7529,7939,15468,6666,8091,521,,0.430954228,0.523079907,0.033682441,,,
Jenkins County,Georgia,13,165,13165,8674,4621,4053,8674,4975,3294,365,,0.573553147,0.379755591,0.042079779,,,
Johnson County,Georgia,13,167,13167,9192,5576,3616,9192,5738,3073,194,,0.624238468,0.334312446,0.021105309,,,
Jones County,Georgia,13,169,13169,28526,13871,14655,28526,20170,7153,571,,0.707074248,0.250753698,0.020016827,,,
Lamar County,Georgia,13,171,13171,19098,9300,9798,19098,12702,5436,159,,0.665095822,0.284637135,0.008325479,,,
Lanier County,Georgia,13,173,13173,10094,4962,5132,10094,6723,2469,679,,0.666039231,0.244600753,0.067267684,,,
Laurens County,Georgia,13,175,13175,49619,23384,26235,49619,28351,18593,1530,,0.571373869,0.374715331,0.030834962,,,
Lee County,Georgia,13,177,13177,33337,16717,16620,33337,22706,7785,1077,,0.681105078,0.233524312,0.032306446,,,
Liberty County,Georgia,13,179,13179,66826,34458,32368,66826,26550,28654,8298,,0.397300452,0.428785203,0.124173226,,,
Lincoln County,Georgia,13,181,13181,7773,3778,3995,7773,5334,2121,103,,0.686221536,0.272867619,0.013250997,,,
Long County,Georgia,13,183,13183,17512,8809,8703,17512,9747,4554,2232,,0.556589767,0.260050251,0.127455459,,,
Lowndes County,Georgia,13,185,13185,119055,57564,61491,119055,62733,44220,8169,,0.526924531,0.371424972,0.068615346,,,
Lumpkin County,Georgia,13,187,13187,33931,16751,17180,33931,30747,623,1916,,0.906162506,0.018360791,0.056467537,,,
McDuffie County,Georgia,13,189,13189,21687,10683,11004,21687,11932,8911,777,,0.550191359,0.410891317,0.035827915,,,
McIntosh County,Georgia,13,191,13191,11187,5626,5561,11187,7076,3333,282,,0.632519889,0.297935103,0.025207831,,,
Macon County,Georgia,13,193,13193,11953,6536,5417,11953,3999,7062,524,,0.334560361,0.590814022,0.043838367,,,
Madison County,Georgia,13,195,13195,30914,15001,15913,30914,24550,2853,2127,,0.794138578,0.092288284,0.068803778,,,
Marion County,Georgia,13,197,13197,7474,3586,3888,7474,4420,2155,588,,0.591383463,0.288332887,0.078672732,,,
Meriwether County,Georgia,13,199,13199,20757,9850,10907,20757,11987,7926,569,,0.57749193,0.381847088,0.027412439,,,
Miller County,Georgia,13,201,13201,5873,2767,3106,5873,3854,1604,183,,0.656223395,0.273114252,0.031159544,,,
Mitchell County,Georgia,13,205,13205,21441,10967,10474,21441,10124,9862,1072,,0.472179469,0.45995989,0.049997668,,,
Monroe County,Georgia,13,207,13207,28919,14516,14403,28919,21226,6250,782,,0.73398112,0.216120889,0.027041046,,,
Montgomery County,Georgia,13,209,13209,8675,4473,4202,8675,5867,1991,618,,0.676311239,0.229510086,0.071239193,,,
Morgan County,Georgia,13,211,13211,20614,10199,10415,20614,15139,4472,739,,0.734403803,0.216939944,0.035849423,,,
Murray County,Georgia,13,213,13213,40282,20191,20091,40282,35156,246,6287,,0.872747133,0.006106946,0.156074674,,,
Muscogee County,Georgia,13,215,13215,204383,98513,105870,204383,80261,95491,16884,,0.392699001,0.467215962,0.08260961,,,
Newton County,Georgia,13,217,13217,115530,53871,61659,115530,48471,54805,7813,,0.419553363,0.474378949,0.067627456,,,
Oconee County,Georgia,13,219,13219,42788,21161,21627,42788,35795,1425,2466,,0.836566327,0.03330373,0.057632981,,,
Oglethorpe County,Georgia,13,221,13221,15221,7670,7551,15221,11440,2421,966,,0.751593194,0.159056567,0.06346495,,,
Paulding County,Georgia,13,223,13223,174292,85332,88960,174292,115162,38312,14256,,0.660741744,0.219815023,0.081793771,,,
Peach County,Georgia,13,225,13225,28269,13876,14393,28269,13219,12240,2585,,0.467614702,0.432983126,0.091442923,,,
Pickens County,Georgia,13,227,13227,34197,16976,17221,34197,31843,170,1294,,0.931163552,0.004971196,0.037839577,,,
Pierce County,Georgia,13,229,13229,19996,10184,9812,19996,16928,1965,1035,,0.846569314,0.098269654,0.051760352,,,
Pike County,Georgia,13,231,13231,19540,9516,10024,19540,17145,1665,412,,0.877430911,0.085209826,0.021084954,,,
Polk County,Georgia,13,233,13233,43365,21335,22030,43365,32749,5179,5843,,0.755194281,0.11942811,0.134739998,,,
Pulaski County,Georgia,13,235,13235,9893,4251,5642,9893,5740,3283,641,,0.580208228,0.331850804,0.064793288,,,
Putnam County,Georgia,13,237,13237,22524,11091,11433,22524,15052,5757,1568,,0.668264962,0.255594033,0.069614633,,,
Quitman County,Georgia,13,239,13239,2092,1158,934,2092,1012,1044,25,,0.48374761,0.499043977,0.011950287,,,
Rabun County,Georgia,13,241,13241,17107,8351,8756,17107,15134,156,1481,,0.884667095,0.009119074,0.086572748,,,
Randolph County,Georgia,13,243,13243,6270,2804,3466,6270,1718,4246,223,,0.27400319,0.677192982,0.035566188,,,
Richmond County,Georgia,13,245,13245,206040,99708,106332,206040,68749,115506,11627,,0.33366822,0.560599884,0.05643079,,,
Rockdale County,Georgia,13,247,13247,94293,44396,49897,94293,26640,54424,9994,,0.282523623,0.577179642,0.10598878,,,
Schley County,Georgia,13,249,13249,4539,2204,2335,4539,3554,779,96,,0.782991848,0.171623706,0.021150033,,,
Screven County,Georgia,13,251,13251,14057,6702,7355,14057,7865,5569,348,,0.559507719,0.396172725,0.024756349,,,
Seminole County,Georgia,13,253,13253,9117,4385,4732,9117,5755,3052,267,,0.631238346,0.334759241,0.029285949,,,
Spalding County,Georgia,13,255,13255,68215,32482,35733,68215,38826,24149,3943,,0.569171003,0.354013047,0.057802536,,,
Stephens County,Georgia,13,257,13257,26842,12778,14064,26842,21823,2857,987,,0.813016914,0.106437672,0.036770732,,,
Stewart County,Georgia,13,259,13259,4978,3288,1690,4978,1366,3014,538,,0.274407393,0.605464042,0.108075532,,,
Sumter County,Georgia,13,261,13261,29174,13551,15623,29174,12088,14534,1799,,0.414341537,0.498183314,0.061664496,,,
Talbot County,Georgia,13,263,13263,5753,2756,2997,5753,2340,3176,65,,0.406744307,0.552059795,0.011298453,,,
Taliaferro County,Georgia,13,265,13265,1740,808,932,1740,725,777,101,,0.416666667,0.446551724,0.058045977,,,
Tattnall County,Georgia,13,267,13267,24215,14090,10125,24215,14086,6664,2552,,0.581705554,0.275201321,0.105389222,,,
Taylor County,Georgia,13,269,13269,7786,3706,4080,7786,4559,3014,61,,0.585538145,0.38710506,0.007834575,,,
Telfair County,Georgia,13,271,13271,12174,6994,5180,12174,6303,4476,1884,,0.51774273,0.367668802,0.154756037,,,
Terrell County,Georgia,13,273,13273,8941,4439,4502,8941,3252,5352,219,,0.363717705,0.598590762,0.024493904,,,
Thomas County,Georgia,13,275,13275,45696,21648,24048,45696,26633,16377,1730,,0.582830007,0.358390231,0.037858894,,,
Tift County,Georgia,13,277,13277,41322,20012,21310,41322,23623,11996,5334,,0.571680945,0.290305406,0.129083781,,,
Toombs County,Georgia,13,279,13279,26943,13004,13939,26943,17052,6399,3154,,0.63289166,0.237501392,0.117061946,,,
Towns County,Georgia,13,281,13281,12739,6215,6524,12739,11916,213,419,,0.935395243,0.016720308,0.032891122,,,
Treutlen County,Georgia,13,283,13283,6387,3289,3098,6387,4117,2000,39,,0.644590575,0.313136058,0.006106153,,,
Troup County,Georgia,13,285,13285,69821,33343,36478,69821,38943,25486,3077,,0.55775483,0.36501912,0.044069836,,,
Turner County,Georgia,13,287,13287,8915,4145,4770,8915,4983,3356,415,,0.558945597,0.376444195,0.046550757,,,
Twiggs County,Georgia,13,289,13289,7869,3944,3925,7869,4362,3195,61,,0.554327106,0.406023637,0.007751938,,,
Union County,Georgia,13,291,13291,25598,12694,12904,25598,23925,225,920,,0.934643332,0.008789749,0.035940308,,,
Upson County,Georgia,13,293,13293,27856,13283,14573,27856,18851,7382,702,,0.676730327,0.265005744,0.025201034,,,
Walker County,Georgia,13,295,13295,68449,34079,34370,68449,61967,2994,1855,,0.905301758,0.043740595,0.027100469,,,
Walton County,Georgia,13,297,13297,100361,49097,51264,100361,72390,19800,6110,,0.721296121,0.197287791,0.060880222,,,
Ware County,Georgia,13,299,13299,35958,18043,17915,35958,22336,10748,1711,,0.621169142,0.298904277,0.047583292,,,
Warren County,Georgia,13,301,13301,5175,2410,2765,5175,2041,2981,57,,0.394396135,0.576038647,0.011014493,,,
Washington County,Georgia,13,303,13303,19893,10236,9657,19893,8413,10262,393,,0.422912582,0.51585985,0.019755693,,,
Wayne County,Georgia,13,305,13305,30519,15202,15317,30519,21987,6076,1857,,0.720436449,0.199089092,0.060847341,,,
Webster County,Georgia,13,307,13307,2348,1217,1131,2348,1080,1151,166,,0.459965928,0.490204429,0.070698467,,,
Wheeler County,Georgia,13,309,13309,7434,4844,2590,7434,4385,2859,315,,0.589857412,0.384584342,0.042372881,,,
White County,Georgia,13,311,13311,28454,14024,14430,28454,25797,583,992,,0.906621213,0.020489211,0.034863288,,,
Whitfield County,Georgia,13,313,13313,103118,51588,51530,103118,71835,3508,37703,,0.696629105,0.034019279,0.365629667,,,
Wilcox County,Georgia,13,315,13315,8784,5288,3496,8784,5383,2943,322,,0.612818761,0.335040984,0.036657559,,,
Wilkes County,Georgia,13,317,13317,9553,4642,4911,9553,4971,3916,443,,0.520360096,0.409923584,0.046372867,,,
Wilkinson County,Georgia,13,319,13319,8795,4218,4577,8795,4873,3361,277,,0.55406481,0.382148948,0.031495168,,,
Worth County,Georgia,13,321,13321,20575,9744,10831,20575,13907,4981,463,,0.675917375,0.242089915,0.022503038,,,
Hawaii County,Hawaii,15,001,15001,203684,101283,102401,203684,63413,1599,23451,,0.311330296,0.007850396,0.115134228,,,
Honolulu County,Hawaii,15,003,15003,1003666,507355,496311,1003666,188777,24427,93725,,0.188087471,0.024337778,0.093382659,,,
Kalawao County,Hawaii,15,005,15005,43,29,14,43,11,0,4,,0.255813953,0,0.093023256,,,
Kauai County,Hawaii,15,007,15007,73610,36699,36911,73610,22151,466,7720,,0.300923788,0.006330662,0.104877055,,,
Maui County,Hawaii,15,009,15009,164632,82107,82525,164632,51004,1248,17325,,0.309806113,0.007580543,0.105234705,,,
Ada County,Idaho,16,001,16001,508052,255975,252077,508052,430629,6510,48291,,0.847608119,0.012813649,0.095051294,,,
Adams County,Idaho,16,003,16003,4599,2359,2240,4599,4212,11,210,,0.915851272,0.002391824,0.0456621,,,
Bannock County,Idaho,16,005,16005,88457,44403,44054,88457,74579,831,8481,,0.843110212,0.009394395,0.095877093,,,
Bear Lake County,Idaho,16,007,16007,6552,3326,3226,6552,6183,18,244,,0.943681319,0.002747253,0.037240537,,,
Benewah County,Idaho,16,009,16009,9913,5082,4831,9913,8423,73,355,,0.849692323,0.007364067,0.035811561,,,
Bingham County,Idaho,16,011,16011,48993,24598,24395,48993,38751,133,8619,,0.790949728,0.002714674,0.175923091,,,
Blaine County,Idaho,16,013,16013,24579,12920,11659,24579,19732,117,5221,,0.802799137,0.004760161,0.212417104,,,
Boise County,Idaho,16,015,16015,8045,4085,3960,8045,7032,17,383,,0.874083282,0.002113114,0.047607209,,,
Bonner County,Idaho,16,017,16017,49456,24740,24716,49456,45000,129,1804,,0.909899709,0.002608379,0.036476868,,,
Bonneville County,Idaho,16,019,16019,127056,63711,63345,127056,108446,681,17992,,0.853529152,0.005359841,0.141606851,,,
Boundary County,Idaho,16,021,16021,12695,6493,6202,12695,11271,94,706,,0.887829854,0.00740449,0.055612446,,,
Butte County,Idaho,16,023,16023,2654,1354,1300,2654,2449,0,206,,0.922758101,0,0.077618689,,,
Camas County,Idaho,16,025,16025,1155,542,613,1155,902,0,164,,0.780952381,0,0.141991342,,,
Canyon County,Idaho,16,027,16027,242405,120832,121573,242405,180189,1589,62458,,0.743338628,0.006555145,0.257659702,,,
Caribou County,Idaho,16,029,16029,7118,3668,3450,7118,6540,0,399,,0.918797415,0,0.056055072,,,
Cassia County,Idaho,16,031,16031,25165,12928,12237,25165,18194,21,7408,,0.722988277,0.000834492,0.294377111,,,
Clark County,Idaho,16,033,16033,776,413,363,776,521,0,238,,0.671391753,0,0.306701031,,,
Clearwater County,Idaho,16,035,16035,8921,4915,4006,8921,8020,18,379,,0.899002354,0.002017711,0.042484026,,,
Custer County,Idaho,16,037,16037,4411,2297,2114,4411,3967,12,131,,0.899342553,0.002720472,0.029698481,,,
Elmore County,Idaho,16,039,16039,29046,15493,13553,29046,21649,921,5223,,0.745334986,0.031708325,0.179818219,,,
Franklin County,Idaho,16,041,16041,14715,7597,7118,14715,13518,0,1073,,0.918654434,0,0.07291879,,,
Fremont County,Idaho,16,043,16043,13701,7095,6606,13701,12171,39,1656,,0.888329319,0.002846508,0.12086709,,,
Gem County,Idaho,16,045,16045,19854,10115,9739,19854,17322,37,1852,,0.872469024,0.001863604,0.093280951,,,
Gooding County,Idaho,16,047,16047,15740,7943,7797,15740,11348,10,4876,,0.720965693,0.000635324,0.30978399,,,
Idaho County,Idaho,16,049,16049,17120,8953,8167,17120,15686,16,649,,0.916238318,0.000934579,0.037908879,,,
Jefferson County,Idaho,16,051,16051,32234,16537,15697,32234,28459,40,3485,,0.882887634,0.001240926,0.108115654,,,
Jerome County,Idaho,16,053,16053,24788,12797,11991,24788,17326,28,9532,,0.698967242,0.001129579,0.384540907,,,
Kootenai County,Idaho,16,055,16055,177736,88630,89106,177736,156689,533,9663,,0.881582797,0.00299883,0.054367151,,,
Latah County,Idaho,16,057,16057,40315,20670,19645,40315,35722,420,2057,,0.886072182,0.010417959,0.051023192,,,
Lemhi County,Idaho,16,059,16059,8166,4152,4014,8166,7521,1,148,,0.92101396,0.000122459,0.018123928,,,
Lewis County,Idaho,16,061,16061,3649,1826,1823,3649,3042,62,148,,0.833653056,0.016990956,0.040559057,,,
Lincoln County,Idaho,16,063,16063,5276,2759,2517,5276,3659,34,1689,,0.693517817,0.006444276,0.320128886,,,
Madison County,Idaho,16,065,16065,53578,24193,29385,53578,47220,492,5203,,0.88133189,0.009182874,0.097110754,,,
Minidoka County,Idaho,16,067,16067,21922,11236,10686,21922,15808,67,8042,,0.721102089,0.00305629,0.366846091,,,
Nez Perce County,Idaho,16,069,16069,42477,21083,21394,42477,37533,43,1813,,0.883607599,0.001012313,0.042681922,,,
Oneida County,Idaho,16,071,16071,4681,2303,2378,4681,4403,17,204,,0.940610981,0.003631703,0.043580432,,,
Owyhee County,Idaho,16,073,16073,12284,6363,5921,12284,8979,59,3049,,0.73095083,0.004802996,0.248209052,,,
Payette County,Idaho,16,075,16075,26190,13098,13092,26190,21608,22,4589,,0.825047728,0.000840015,0.175219549,,,
Power County,Idaho,16,077,16077,8018,4153,3865,8018,5244,72,2710,,0.654028436,0.008979795,0.337989524,,,
Shoshone County,Idaho,16,079,16079,13580,6762,6818,13580,12345,127,537,,0.909057437,0.009351988,0.039543446,,,
Teton County,Idaho,16,081,16081,12101,6171,5930,12101,9967,0,2069,,0.823650938,0,0.170977605,,,
Twin Falls County,Idaho,16,083,16083,92121,45751,46370,92121,75172,784,16150,,0.816013721,0.008510546,0.175312904,,,
Valley County,Idaho,16,085,16085,12136,6393,5743,12136,11538,18,619,,0.950725115,0.001483191,0.051005274,,,
Washington County,Idaho,16,087,16087,10866,5366,5500,10866,9051,12,1741,,0.832965213,0.001104362,0.160224554,,,
Adams County,Illinois,17,001,17001,65166,31962,33204,65166,59271,2320,1312,,0.909538717,0.035601387,0.020133198,,,
Alexander County,Illinois,17,003,17003,5042,2463,2579,5042,3186,1642,67,,0.631892106,0.325664419,0.013288378,,,
Bond County,Illinois,17,005,17005,16627,8869,7758,16627,14765,1144,629,,0.888013472,0.068803753,0.037830035,,,
Boone County,Illinois,17,007,17007,53316,26675,26641,53316,39578,1312,13273,,0.742328757,0.024607998,0.248949659,,,
Brown County,Illinois,17,009,17009,6320,3945,2375,6320,4777,1091,321,,0.75585443,0.172626582,0.050791139,,,
Bureau County,Illinois,17,011,17011,33027,16343,16684,33027,29410,212,3251,,0.890483544,0.006418991,0.098434614,,,
Calhoun County,Illinois,17,013,17013,4406,2272,2134,4406,4183,45,42,,0.949387199,0.010213345,0.009532456,,,
Carroll County,Illinois,17,015,17015,15621,8499,7122,15621,14177,604,794,,0.907560335,0.038665898,0.050829012,,,
Cass County,Illinois,17,017,17017,12826,6272,6554,12826,9965,489,2808,,0.776937471,0.038125682,0.218930298,,,
Champaign County,Illinois,17,019,17019,206098,102540,103558,206098,136542,27538,16628,,0.662510068,0.133616047,0.080680065,,,
Christian County,Illinois,17,021,17021,33684,17479,16205,33684,31334,890,1093,,0.930233939,0.02642204,0.03244864,,,
Clark County,Illinois,17,023,17023,15328,7666,7662,15328,14692,106,274,,0.958507307,0.006915449,0.017875783,,,
Clay County,Illinois,17,025,17025,13173,6596,6577,13173,12562,93,88,,0.953617247,0.007059895,0.006680331,,,
Clinton County,Illinois,17,027,17027,36899,19132,17767,36899,33710,1164,1430,,0.913574894,0.03154557,0.038754438,,,
Coles County,Illinois,17,029,17029,46689,22964,23725,46689,42170,1783,1721,,0.903210606,0.038188867,0.036860931,,,
Cook County,Illinois,17,031,17031,5185812,2530756,2655056,5185812,2408676,1165825,1374034,,0.464474223,0.224810502,0.264960242,,,
Crawford County,Illinois,17,033,17033,18588,9853,8735,18588,16942,656,470,,0.911448246,0.035291586,0.02528513,,,
Cumberland County,Illinois,17,035,17035,10378,5345,5033,10378,9960,15,33,,0.95972249,0.001445365,0.003179803,,,
DeKalb County,Illinois,17,037,17037,100512,50015,50497,100512,76672,7815,14075,,0.76281439,0.07775191,0.140033031,,,
De Witt County,Illinois,17,039,17039,15461,7767,7694,15461,14610,160,520,,0.944958282,0.010348619,0.033633012,,,
Douglas County,Illinois,17,041,17041,19686,9733,9953,19686,17814,267,1603,,0.904907041,0.013562938,0.081428426,,,
DuPage County,Illinois,17,043,17043,927263,458960,468303,927263,623577,46564,145993,,0.672492055,0.050216605,0.157445083,,,
Edgar County,Illinois,17,045,17045,16637,8164,8473,16637,16023,104,238,,0.963094308,0.006251127,0.014305464,,,
Edwards County,Illinois,17,047,17047,6118,3002,3116,6118,5851,11,82,,0.956358287,0.001797973,0.013403073,,,
Effingham County,Illinois,17,049,17049,34505,17409,17096,34505,33097,226,905,,0.95919432,0.006549775,0.026228083,,,
Fayette County,Illinois,17,051,17051,21380,11213,10167,21380,19113,805,620,,0.893966324,0.037652011,0.028999065,,,
Ford County,Illinois,17,053,17053,13396,6691,6705,13396,12258,112,621,,0.915049268,0.008360705,0.046357122,,,
Franklin County,Illinois,17,055,17055,37541,18687,18854,37541,35597,168,709,,0.948216616,0.004475107,0.018886018,,,
Fulton County,Illinois,17,057,17057,33259,17330,15929,33259,30913,858,808,,0.929462702,0.025797528,0.024294176,,,
Gallatin County,Illinois,17,059,17059,4857,2429,2428,4857,4666,33,38,,0.960675314,0.006794317,0.00782376,,,
Greene County,Illinois,17,061,17061,11837,5951,5886,11837,11375,82,119,,0.96096984,0.006927431,0.010053223,,,
Grundy County,Illinois,17,063,17063,52920,26628,26292,52920,46772,1127,6081,,0.883824641,0.021296296,0.114909297,,,
Hamilton County,Illinois,17,065,17065,7972,4015,3957,7972,7654,4,107,,0.960110386,0.000501756,0.013421977,,,
Hancock County,Illinois,17,067,17067,17434,8814,8620,17434,16571,132,352,,0.950499025,0.007571412,0.020190432,,,
Hardin County,Illinois,17,069,17069,3623,1859,1764,3623,3488,43,42,,0.962738062,0.011868617,0.011592603,,,
Henderson County,Illinois,17,071,17071,6284,3166,3118,6284,5980,16,122,,0.95162317,0.002546149,0.019414386,,,
Henry County,Illinois,17,073,17073,48948,24264,24684,48948,43316,1071,3284,,0.884939119,0.021880363,0.067091607,,,
Iroquois County,Illinois,17,075,17075,26746,13208,13538,26746,23962,182,2132,,0.895909669,0.006804756,0.079712854,,,
Jackson County,Illinois,17,077,17077,52706,26013,26693,52706,38775,7605,2772,,0.735684742,0.144290973,0.052593633,,,
Jasper County,Illinois,17,079,17079,9233,4681,4552,9233,8966,10,106,,0.971081989,0.001083072,0.011480559,,,
Jefferson County,Illinois,17,081,17081,36808,18949,17859,36808,31241,2398,1003,,0.848755705,0.065148881,0.027249511,,,
Jersey County,Illinois,17,083,17083,21336,10395,10941,21336,20341,124,330,,0.953365204,0.005811774,0.015466817,,,
Jo Daviess County,Illinois,17,085,17085,21918,11035,10883,21918,20607,181,879,,0.940186148,0.008258053,0.040104024,,,
Johnson County,Illinois,17,087,17087,13350,7606,5744,13350,10971,1010,567,,0.821797753,0.075655431,0.04247191,,,
Kane County,Illinois,17,089,17089,516097,258484,257613,516097,318622,26357,170629,,0.61736844,0.051069857,0.330614206,,,
Kankakee County,Illinois,17,091,17091,106833,52878,53955,106833,79585,15612,12948,,0.744947722,0.146134621,0.121198506,,,
Kendall County,Illinois,17,093,17093,135053,67399,67654,135053,93354,11247,29273,,0.691239736,0.083278417,0.216751942,,,
Knox County,Illinois,17,095,17095,49294,25173,24121,49294,41048,3834,3090,,0.832717978,0.077778229,0.062685114,,,
Lake County,Illinois,17,097,17097,711885,358153,353732,711885,455739,47294,173796,,0.640186266,0.066434888,0.244134938,,,
LaSalle County,Illinois,17,099,17099,109049,55499,53550,109049,94696,2956,11806,,0.868380269,0.02710708,0.108263258,,,
Lawrence County,Illinois,17,101,17101,15137,8488,6649,15137,12917,1020,352,,0.853339499,0.067384554,0.023254278,,,
Lee County,Illinois,17,103,17103,34058,17980,16078,34058,29546,1826,2443,,0.867520113,0.053614422,0.071730577,,,
Livingston County,Illinois,17,105,17105,35659,18301,17358,35659,32197,1253,1975,,0.90291371,0.035138394,0.055385737,,,
Logan County,Illinois,17,107,17107,27870,13905,13965,27870,24540,1660,924,,0.880516685,0.059562253,0.033153929,,,
McDonough County,Illinois,17,109,17109,27102,13352,13750,27102,23610,1578,935,,0.87115342,0.058224485,0.034499299,,,
McHenry County,Illinois,17,111,17111,311366,155872,155494,311366,256708,4854,48557,,0.824457391,0.015589371,0.155948305,,,
McLean County,Illinois,17,113,17113,170882,83567,87315,170882,135586,14421,10700,,0.79344811,0.084391568,0.062616308,,,
Macon County,Illinois,17,115,17115,102591,49204,53387,102591,77128,17554,2821,,0.75180084,0.171106627,0.027497539,,,
Macoupin County,Illinois,17,117,17117,44566,22069,22497,44566,42165,534,587,,0.946124849,0.011982229,0.013171476,,,
Madison County,Illinois,17,119,17119,264631,129444,135187,264631,222292,22853,11039,,0.840007407,0.086357985,0.04171469,,,
Marion County,Illinois,17,121,17121,37294,18330,18964,37294,33714,1572,798,,0.904006006,0.042151553,0.021397544,,,
Marshall County,Illinois,17,123,17123,11715,5895,5820,11715,10981,49,379,,0.937345284,0.004182672,0.032351686,,,
Mason County,Illinois,17,125,17125,12878,6355,6523,12878,12368,113,189,,0.960397577,0.008774654,0.014676192,,,
Massac County,Illinois,17,127,17127,13958,6807,7151,13958,12270,883,388,,0.879065769,0.063261212,0.027797679,,,
Menard County,Illinois,17,129,17129,12169,5956,6213,12169,11650,56,188,,0.957350645,0.004601857,0.015449092,,,
Mercer County,Illinois,17,131,17131,15619,7882,7737,15619,14802,88,514,,0.947691914,0.005634164,0.032908637,,,
Monroe County,Illinois,17,133,17133,34969,17612,17357,34969,33615,208,656,,0.961279991,0.005948125,0.018759473,,,
Montgomery County,Illinois,17,135,17135,28078,14886,13192,28078,26225,756,597,,0.934005271,0.026924995,0.021262198,,,
Morgan County,Illinois,17,137,17137,32621,16225,16396,32621,28824,1724,906,,0.883602587,0.052849391,0.02777352,,,
Moultrie County,Illinois,17,139,17139,14469,7142,7327,14469,13894,153,228,,0.960259866,0.010574331,0.015757827,,,
Ogle County,Illinois,17,141,17141,51536,25730,25806,51536,45203,627,5927,,0.877115026,0.012166253,0.115006985,,,
Peoria County,Illinois,17,143,17143,179831,87674,92157,179831,123328,31509,10348,,0.685799445,0.175214507,0.057542915,,,
Perry County,Illinois,17,145,17145,20810,11237,9573,20810,18000,1661,731,,0.864968765,0.079817395,0.035127343,,,
Piatt County,Illinois,17,147,17147,16702,8292,8410,16702,15970,266,261,,0.956172913,0.015926236,0.015626871,,,
Pike County,Illinois,17,149,17149,14625,7295,7330,14625,14052,74,283,,0.960820513,0.005059829,0.019350427,,,
Pope County,Illinois,17,151,17151,3757,1942,1815,3757,3365,189,96,,0.895661432,0.050306095,0.025552302,,,
Pulaski County,Illinois,17,153,17153,5074,2601,2473,5074,3186,1640,98,,0.627906977,0.323216397,0.019314151,,,
Putnam County,Illinois,17,155,17155,5600,2889,2711,5600,5202,13,359,,0.928928571,0.002321429,0.064107143,,,
Randolph County,Illinois,17,157,17157,30142,16335,13807,30142,26199,2404,1094,,0.869185854,0.079755822,0.036294871,,,
Richland County,Illinois,17,159,17159,15675,7806,7869,15675,14744,71,298,,0.940606061,0.004529506,0.019011164,,,
Rock Island County,Illinois,17,161,17161,142995,70765,72230,142995,104439,15668,20013,,0.730368195,0.109570265,0.139955943,,,
St. Clair County,Illinois,17,163,17163,254777,123563,131214,254777,155810,71311,12600,,0.611554418,0.279895752,0.049455014,,,
Saline County,Illinois,17,165,17165,23387,11475,11912,23387,21617,654,486,,0.924316928,0.027964254,0.020780776,,,
Sangamon County,Illinois,17,167,17167,195217,94270,100947,195217,154464,24703,5451,,0.791242566,0.126541234,0.027922773,,,
Schuyler County,Illinois,17,169,17169,6826,3755,3071,6826,6297,318,169,,0.922502197,0.046586581,0.024758277,,,
Scott County,Illinois,17,171,17171,4847,2470,2377,4847,4637,60,71,,0.956674231,0.012378791,0.014648236,,,
Shelby County,Illinois,17,173,17173,20867,10381,10486,20867,20200,24,241,,0.968035654,0.001150141,0.011549336,,,
Stark County,Illinois,17,175,17175,5324,2661,2663,5324,4957,55,134,,0.931066867,0.010330579,0.025169046,,,
Stephenson County,Illinois,17,177,17177,44042,21502,22540,44042,36152,3714,2335,,0.820852822,0.084328595,0.053017574,,,
Tazewell County,Illinois,17,179,17179,130555,64723,65832,130555,122633,1830,3355,,0.939320593,0.014017081,0.025697982,,,
Union County,Illinois,17,181,17181,16972,8631,8341,16972,15364,135,882,,0.905255715,0.007954278,0.051967947,,,
Vermilion County,Illinois,17,183,17183,73179,36614,36565,73179,57768,10827,3968,,0.789406797,0.147952281,0.054223206,,,
Wabash County,Illinois,17,185,17185,11199,5501,5698,11199,10521,117,208,,0.93945888,0.010447361,0.018573087,,,
Warren County,Illinois,17,187,17187,16576,8311,8265,16576,14067,464,1791,,0.848636583,0.027992278,0.10804778,,,
Washington County,Illinois,17,189,17189,13682,6957,6725,13682,13078,106,216,,0.955854407,0.007747405,0.015787166,,,
Wayne County,Illinois,17,191,17191,15994,7999,7995,15994,15362,52,259,,0.960485182,0.003251219,0.016193573,,,
White County,Illinois,17,193,17193,13708,6776,6932,13708,13196,90,205,,0.962649548,0.006565509,0.014954771,,,
Whiteside County,Illinois,17,195,17195,55192,27659,27533,55192,48497,592,7212,,0.878696188,0.010726192,0.130671112,,,
Will County,Illinois,17,197,17197,698450,348402,350048,698450,454217,82371,134835,,0.650321426,0.117933997,0.193048894,,,
Williamson County,Illinois,17,199,17199,66902,33638,33264,66902,59702,2333,1881,,0.892379899,0.034871902,0.028115751,,,
Winnebago County,Illinois,17,201,17201,283289,138817,144472,283289,195682,37802,42452,,0.690750435,0.133439703,0.149854036,,,
Woodford County,Illinois,17,203,17203,38348,19255,19093,38348,36417,242,765,,0.949645353,0.006310629,0.019948889,,,
Adams County,Indiana,18,001,18001,35995,18008,17987,35995,33861,149,1688,,0.940713988,0.004139464,0.046895402,,,
Allen County,Indiana,18,003,18003,388791,191288,197503,388791,282728,42329,34095,,0.727197903,0.108873405,0.087694931,,,
Bartholomew County,Indiana,18,005,18005,82881,41932,40949,82881,66376,1481,7445,,0.800859063,0.017868993,0.089827584,,,
Benton County,Indiana,18,007,18007,8708,4464,4244,8708,8014,128,608,,0.920303169,0.014699127,0.069820854,,,
Blackford County,Indiana,18,009,18009,12007,5875,6132,12007,11433,56,263,,0.952194553,0.004663946,0.021903889,,,
Boone County,Indiana,18,011,18011,72827,36309,36518,72827,64543,1779,2991,,0.886250978,0.024427753,0.041069933,,,
Brown County,Indiana,18,013,18013,15543,7776,7767,15543,14697,93,312,,0.945570353,0.005983401,0.020073345,,,
Carroll County,Indiana,18,015,18015,20443,10398,10045,20443,19412,148,899,,0.949567089,0.007239642,0.043975933,,,
Cass County,Indiana,18,017,18017,37703,18833,18870,37703,30508,494,6810,,0.809166379,0.013102406,0.180622232,,,
Clark County,Indiana,18,019,18019,122800,60330,62470,122800,102242,8652,8166,,0.832589577,0.070456026,0.066498371,,,
Clay County,Indiana,18,021,18021,26431,13092,13339,26431,25112,81,496,,0.950096478,0.003064583,0.018765843,,,
Clinton County,Indiana,18,023,18023,32967,16461,16506,32967,27478,215,6252,,0.833500167,0.006521673,0.18964419,,,
Crawford County,Indiana,18,025,18025,10494,5295,5199,10494,10005,28,33,,0.953401944,0.002668191,0.003144654,,,
Daviess County,Indiana,18,027,18027,33442,16680,16762,33442,30213,549,2144,,0.90344477,0.016416482,0.064110998,,,
Dearborn County,Indiana,18,029,18029,50828,25367,25461,50828,48385,111,771,,0.951935941,0.002183836,0.015168805,,,
Decatur County,Indiana,18,031,18031,26411,13213,13198,26411,24739,84,640,,0.936693045,0.003180493,0.024232327,,,
DeKalb County,Indiana,18,033,18033,43584,21753,21831,43584,41393,92,1280,,0.949729258,0.002110866,0.029368576,,,
Delaware County,Indiana,18,035,18035,112109,54201,57908,112109,96750,5949,3552,,0.862999402,0.053064428,0.031683451,,,
Dubois County,Indiana,18,037,18037,43563,21924,21639,43563,39014,717,4220,,0.895576521,0.016458922,0.096871198,,,
Elkhart County,Indiana,18,039,18039,206868,102631,104237,206868,155801,10154,40368,,0.7531421,0.04908444,0.195138929,,,
Fayette County,Indiana,18,041,18041,23390,11559,11831,23390,22107,266,318,,0.945147499,0.011372381,0.013595554,,,
Floyd County,Indiana,18,043,18043,80512,39370,41142,80512,69925,4074,3256,,0.868504074,0.050601153,0.040441176,,,
Fountain County,Indiana,18,045,18045,16546,8294,8252,16546,15656,127,472,,0.946210564,0.007675571,0.028526532,,,
Franklin County,Indiana,18,047,18047,22929,11399,11530,22929,22100,34,258,,0.963844913,0.001482838,0.011252126,,,
Fulton County,Indiana,18,049,18049,20411,10326,10085,20411,18605,87,1097,,0.911518299,0.004262408,0.053745529,,,
Gibson County,Indiana,18,051,18051,32986,16743,16243,32986,30067,739,709,,0.911507912,0.022403444,0.021493967,,,
Grant County,Indiana,18,053,18053,66377,31901,34476,66377,56412,3220,3530,,0.849872697,0.048510779,0.053181072,,,
Greene County,Indiana,18,055,18055,30954,15727,15227,30954,29700,132,605,,0.959488273,0.004264392,0.019545131,,,
Hamilton County,Indiana,18,057,18057,357176,175572,181604,357176,291484,14994,19165,,0.816079468,0.041979304,0.053657021,,,
Hancock County,Indiana,18,059,18059,82013,40923,41090,82013,73769,2570,2613,,0.899479351,0.031336495,0.031860803,,,
Harrison County,Indiana,18,061,18061,39785,20019,19766,39785,38028,351,913,,0.955837627,0.008822421,0.022948347,,,
Hendricks County,Indiana,18,063,18063,179379,90107,89272,179379,144173,16308,8849,,0.803733993,0.090913652,0.049331304,,,
Henry County,Indiana,18,065,18065,48896,25791,23105,48896,45480,1140,1055,,0.930137435,0.023314791,0.021576407,,,
Howard County,Indiana,18,067,18067,83610,40601,43009,83610,71318,6566,3260,,0.852984093,0.078531276,0.038990551,,,
Huntington County,Indiana,18,069,18069,36757,18427,18330,36757,34793,292,1098,,0.946568001,0.007944065,0.029871861,,,
Jackson County,Indiana,18,071,18071,46319,23622,22697,46319,37783,515,6288,,0.815712774,0.011118547,0.135754226,,,
Jasper County,Indiana,18,073,18073,33198,16536,16662,33198,29513,243,2435,,0.888999337,0.007319718,0.073347792,,,
Jay County,Indiana,18,075,18075,20281,10205,10076,20281,19026,62,911,,0.938119422,0.003057048,0.04491889,,,
Jefferson County,Indiana,18,077,18077,33074,15906,17168,33074,30798,363,1125,,0.931184616,0.010975389,0.034014634,,,
Jennings County,Indiana,18,079,18079,27584,14015,13569,27584,26084,148,909,,0.94562065,0.005365429,0.032953886,,,
Johnson County,Indiana,18,081,18081,163983,81232,82751,163983,141281,5014,6744,,0.86155882,0.03057634,0.041126214,,,
Knox County,Indiana,18,083,18083,36108,18348,17760,36108,32678,571,1025,,0.905007201,0.01581367,0.028387061,,,
Kosciusko County,Indiana,18,085,18085,80357,40207,40150,80357,70634,573,7643,,0.879002452,0.007130679,0.095113058,,,
LaGrange County,Indiana,18,087,18087,40596,20637,19959,40596,38381,128,1794,,0.945437974,0.00315302,0.044191546,,,
Lake County,Indiana,18,089,18089,498990,242862,256128,498990,285553,115720,102413,,0.572261969,0.231908455,0.205240586,,,
LaPorte County,Indiana,18,091,18091,112141,58136,54005,112141,88836,11728,8264,,0.792181272,0.104582624,0.07369294,,,
Lawrence County,Indiana,18,093,18093,45077,22254,22823,45077,42747,186,847,,0.948310668,0.004126273,0.01879007,,,
Madison County,Indiana,18,095,18095,130949,66042,64907,130949,111104,8251,6724,,0.848452451,0.063009263,0.051348235,,,
Marion County,Indiana,18,097,18097,971822,470733,501089,971822,526517,268634,129973,,0.541783372,0.276423049,0.13374157,,,
Marshall County,Indiana,18,099,18099,46225,23390,22835,46225,41653,232,5346,,0.901092482,0.005018929,0.115651704,,,
Martin County,Indiana,18,101,18101,9854,5072,4782,9854,9432,15,120,,0.957174751,0.001522224,0.012177796,,,
Miami County,Indiana,18,103,18103,35772,19395,16377,35772,31784,1340,1288,,0.888516158,0.037459466,0.036005815,,,
Monroe County,Indiana,18,105,18105,139822,69703,70119,139822,116590,4973,6441,,0.83384589,0.035566649,0.046065712,,,
Montgomery County,Indiana,18,107,18107,38155,19430,18725,38155,34518,251,2322,,0.904678286,0.00657843,0.060857031,,,
Morgan County,Indiana,18,109,18109,72202,35981,36221,72202,68432,363,1433,,0.94778538,0.005027562,0.019847096,,,
Newton County,Indiana,18,111,18111,13859,7077,6782,13859,12356,141,1083,,0.891550617,0.010173894,0.078144166,,,
Noble County,Indiana,18,113,18113,47417,23960,23457,47417,42052,145,5312,,0.886854925,0.003057975,0.112027332,,,
Ohio County,Indiana,18,115,18115,5993,2976,3017,5993,5696,21,0,,0.950442183,0.003504088,0,,,
Orange County,Indiana,18,117,18117,19746,9906,9840,19746,18414,299,345,,0.9325433,0.015142307,0.017471893,,,
Owen County,Indiana,18,119,18119,21434,10849,10585,21434,20472,121,313,,0.955118037,0.005645237,0.014602967,,,
Parke County,Indiana,18,121,18121,16346,7861,8485,16346,15521,367,264,,0.949528937,0.022451976,0.01615074,,,
Perry County,Indiana,18,123,18123,19218,10489,8729,19218,17914,413,273,,0.932146946,0.02149027,0.014205432,,,
Pike County,Indiana,18,125,18125,12187,6063,6124,12187,11678,31,179,,0.958234184,0.002543694,0.014687782,,,
Porter County,Indiana,18,127,18127,174150,86222,87928,174150,148272,7271,19734,,0.851403962,0.041751364,0.113316107,,,
Posey County,Indiana,18,129,18129,25163,12636,12527,25163,23672,175,378,,0.940746334,0.006954656,0.015022056,,,
Pulaski County,Indiana,18,131,18131,12441,6182,6259,12441,11479,41,485,,0.922675026,0.003295555,0.038984005,,,
Putnam County,Indiana,18,133,18133,37091,19575,17516,37091,33996,1269,806,,0.916556577,0.034213151,0.021730339,,,
Randolph County,Indiana,18,135,18135,24425,12211,12214,24425,22331,192,1216,,0.914268168,0.007860798,0.049785056,,,
Ripley County,Indiana,18,137,18137,29039,14534,14505,29039,27677,65,555,,0.953097558,0.002238369,0.019112228,,,
Rush County,Indiana,18,139,18139,16734,8335,8399,16734,16060,109,300,,0.95972272,0.006513685,0.017927573,,,
St. Joseph County,Indiana,18,141,18141,272574,133472,139102,272574,196634,34362,27729,,0.721396758,0.126064848,0.101730172,,,
Scott County,Indiana,18,143,18143,24468,12112,12356,24468,23213,75,605,,0.948708517,0.003065228,0.024726173,,,
Shelby County,Indiana,18,145,18145,45104,22394,22710,45104,41641,547,2451,,0.923221887,0.012127527,0.054341078,,,
Spencer County,Indiana,18,147,18147,19871,10158,9713,19871,18842,110,691,,0.948215993,0.005535705,0.034774294,,,
Starke County,Indiana,18,149,18149,23300,11747,11553,23300,21922,100,962,,0.940858369,0.004291845,0.041287554,,,
Steuben County,Indiana,18,151,18151,34648,17987,16661,34648,32297,266,1488,,0.932146156,0.007677211,0.042946202,,,
Sullivan County,Indiana,18,153,18153,20766,11294,9472,20766,18912,698,376,,0.910719445,0.033612636,0.01810652,,,
Switzerland County,Indiana,18,155,18155,9914,5038,4876,9914,9446,28,95,,0.952794029,0.002824289,0.009582409,,,
Tippecanoe County,Indiana,18,157,18157,187399,95974,91425,187399,142132,11227,18958,,0.758445883,0.059909605,0.101163827,,,
Tipton County,Indiana,18,159,18159,15329,7722,7607,15329,14482,119,482,,0.944745254,0.007763063,0.031443669,,,
Union County,Indiana,18,161,18161,7028,3475,3553,7028,6742,39,77,,0.959305635,0.005549232,0.010956175,,,
Vanderburgh County,Indiana,18,163,18163,179908,87849,92059,179908,147680,17425,6480,,0.820863997,0.096855059,0.036018409,,,
Vermillion County,Indiana,18,165,18165,15452,7784,7668,15452,14851,0,214,,0.961105359,0,0.01384934,,,
Vigo County,Indiana,18,167,18167,106201,53616,52585,106201,90585,6528,3307,,0.85295807,0.061468348,0.031139066,,,
Wabash County,Indiana,18,169,18169,30901,15162,15739,30901,29170,364,938,,0.943982395,0.011779554,0.030355005,,,
Warren County,Indiana,18,171,18171,8469,4219,4250,8469,8036,8,84,,0.948872358,0.000944622,0.009918526,,,
Warrick County,Indiana,18,173,18173,64650,31764,32886,64650,58751,1334,1504,,0.908754834,0.020634184,0.023263728,,,
Washington County,Indiana,18,175,18175,28167,14001,14166,28167,27033,77,416,,0.959740121,0.002733695,0.014769056,,,
Wayne County,Indiana,18,177,18177,66377,32396,33981,66377,57723,2737,2531,,0.869623514,0.041234162,0.038130678,,,
Wells County,Indiana,18,179,18179,28261,13996,14265,28261,26355,297,1075,,0.932557234,0.010509182,0.038038286,,,
White County,Indiana,18,181,18181,24709,12460,12249,24709,21739,110,2522,,0.879800882,0.004451819,0.102068072,,,
Whitley County,Indiana,18,183,18183,34388,17220,17168,34388,32237,70,906,,0.93744911,0.002035594,0.0263464,,,
Adair County,Iowa,19,001,19001,7471,3765,3706,7471,7091,101,214,,0.949136662,0.01351894,0.02864409,,,
Adams County,Iowa,19,003,19003,3641,1806,1835,3641,3475,13,27,,0.95440813,0.003570448,0.007415545,,,
Allamakee County,Iowa,19,005,19005,14038,7152,6886,14038,12690,246,1225,,0.903974925,0.017523864,0.087263143,,,
Appanoose County,Iowa,19,007,19007,12242,6139,6103,12242,11641,121,212,,0.950906715,0.009884006,0.017317432,,,
Audubon County,Iowa,19,009,19009,5622,2771,2851,5622,5351,15,115,,0.951796514,0.00266809,0.020455354,,,
Benton County,Iowa,19,011,19011,25698,12935,12763,25698,24484,104,479,,0.95275897,0.004047008,0.018639583,,,
Black Hawk County,Iowa,19,013,19013,130693,64319,66374,130693,105125,12565,6579,,0.804365957,0.096141339,0.050339345,,,
Boone County,Iowa,19,015,19015,26669,13655,13014,26669,25174,340,754,,0.943942405,0.012748884,0.028272526,,,
Bremer County,Iowa,19,017,19017,25118,12504,12614,25118,23406,283,502,,0.931841707,0.011266821,0.019985668,,,
Buchanan County,Iowa,19,019,19019,20645,10405,10240,20645,19907,154,372,,0.964252846,0.007459433,0.018018891,,,
Buena Vista County,Iowa,19,021,19021,20684,10656,10028,20684,13633,637,5924,,0.65910849,0.030796751,0.286404951,,,
Butler County,Iowa,19,023,19023,14301,7093,7208,14301,13632,24,231,,0.953220055,0.001678204,0.016152717,,,
Calhoun County,Iowa,19,025,19025,9858,5135,4723,9858,9118,149,251,,0.924934064,0.015114628,0.025461554,,,
Carroll County,Iowa,19,027,19027,20677,10445,10232,20677,19347,173,660,,0.935677323,0.008366784,0.031919524,,,
Cass County,Iowa,19,029,19029,13115,6508,6607,13115,12606,112,341,,0.961189478,0.00853984,0.026000762,,,
Cedar County,Iowa,19,031,19031,18427,9168,9259,18427,17581,95,474,,0.954089108,0.005155478,0.025723124,,,
Cerro Gordo County,Iowa,19,033,19033,42785,21164,21621,42785,38939,957,2331,,0.910108683,0.022367652,0.054481711,,,
Cherokee County,Iowa,19,035,19035,11587,5792,5795,11587,10535,253,551,,0.909208596,0.021834815,0.047553292,,,
Chickasaw County,Iowa,19,037,19037,11868,6073,5795,11868,11325,88,470,,0.954246714,0.007414897,0.039602292,,,
Clarke County,Iowa,19,039,19039,9690,4984,4706,9690,8324,4,1579,,0.859029928,0.000412797,0.162951496,,,
Clay County,Iowa,19,041,19041,16446,8131,8315,16446,15552,90,743,,0.945640277,0.005472455,0.045178159,,,
Clayton County,Iowa,19,043,19043,17069,8612,8457,17069,16368,112,381,,0.958931396,0.006561603,0.022321167,,,
Clinton County,Iowa,19,045,19045,46383,22850,23533,46383,41897,1357,1622,,0.903283531,0.029256409,0.034969709,,,
Crawford County,Iowa,19,047,19047,16289,8184,8105,16289,11418,304,4895,,0.700963841,0.018662901,0.300509546,,,
Dallas County,Iowa,19,049,19049,104136,51787,52349,104136,88381,2568,6954,,0.848707459,0.02466006,0.066778059,,,
Davis County,Iowa,19,051,19051,9127,4630,4497,9127,8733,0,181,,0.956831379,0,0.01983127,,,
Decatur County,Iowa,19,053,19053,7669,3856,3813,7669,7127,126,250,,0.929325857,0.016429782,0.032598774,,,
Delaware County,Iowa,19,055,19055,17549,8923,8626,17549,16770,2,284,,0.955610006,0.000113967,0.016183258,,,
Des Moines County,Iowa,19,057,19057,38597,19035,19562,38597,33312,1628,1351,,0.86307226,0.042179444,0.03500272,,,
Dickinson County,Iowa,19,059,19059,17844,8945,8899,17844,16870,10,478,,0.945415826,0.000560412,0.026787716,,,
Dubuque County,Iowa,19,061,19061,98948,49136,49812,98948,88908,2890,3049,,0.898532563,0.02920726,0.030814165,,,
Emmet County,Iowa,19,063,19063,9316,4681,4635,9316,8252,208,918,,0.885787892,0.022327179,0.098540146,,,
Fayette County,Iowa,19,065,19065,19393,9772,9621,19393,17981,162,566,,0.927190223,0.00835353,0.029185789,,,
Floyd County,Iowa,19,067,19067,15502,7959,7543,15502,14009,185,579,,0.903689846,0.011933944,0.037350019,,,
Franklin County,Iowa,19,069,19069,9977,5064,4913,9977,8679,59,1609,,0.869900772,0.005913601,0.161270923,,,
Fremont County,Iowa,19,071,19071,6570,3332,3238,6570,6141,41,213,,0.934703196,0.006240487,0.032420091,,,
Greene County,Iowa,19,073,19073,8722,4411,4311,8722,8182,12,284,,0.938087595,0.001375831,0.032561339,,,
Grundy County,Iowa,19,075,19075,12352,6144,6208,12352,11876,86,189,,0.961463731,0.006962435,0.015301166,,,
Guthrie County,Iowa,19,077,19077,10646,5315,5331,10646,9999,50,310,,0.939226,0.0046966,0.029118918,,,
Hamilton County,Iowa,19,079,19079,14893,7537,7356,14893,13023,181,1438,,0.874437655,0.012153361,0.096555429,,,
Hancock County,Iowa,19,081,19081,10718,5490,5228,10718,10045,94,620,,0.937208434,0.008770293,0.057846613,,,
Hardin County,Iowa,19,083,19083,16729,8434,8295,16729,15402,168,848,,0.920676669,0.010042441,0.050690418,,,
Harrison County,Iowa,19,085,19085,14645,7457,7188,14645,14088,11,305,,0.961966541,0.00075111,0.020826221,,,
Henry County,Iowa,19,087,19087,20228,10682,9546,20228,17803,537,1092,,0.88011667,0.02654736,0.053984576,,,
Howard County,Iowa,19,089,19089,9459,4746,4713,9459,8876,5,288,,0.938365578,0.000528597,0.030447193,,,
Humboldt County,Iowa,19,091,19091,9573,4785,4788,9573,8793,32,492,,0.91852084,0.003342735,0.051394547,,,
Ida County,Iowa,19,093,19093,6944,3491,3453,6944,6543,61,271,,0.942252304,0.008784562,0.039026498,,,
Iowa County,Iowa,19,095,19095,16547,8453,8094,16547,15697,104,552,,0.948631172,0.006285127,0.033359521,,,
Jackson County,Iowa,19,097,19097,19429,9816,9613,19429,18640,149,288,,0.959390602,0.007668948,0.014823202,,,
Jasper County,Iowa,19,099,19099,37864,19796,18068,37864,35155,589,1110,,0.928454469,0.015555673,0.029315445,,,
Jefferson County,Iowa,19,101,19101,15676,8071,7605,15676,13269,932,632,,0.846453177,0.059453942,0.040316407,,,
Johnson County,Iowa,19,103,19103,154881,77001,77880,154881,120233,11695,10312,,0.776292767,0.075509585,0.066580149,,,
Jones County,Iowa,19,105,19105,20799,10941,9858,20799,19215,420,516,,0.923842492,0.020193279,0.024808885,,,
Keokuk County,Iowa,19,107,19107,9964,5126,4838,9964,9558,65,221,,0.959253312,0.006523485,0.022179847,,,
Kossuth County,Iowa,19,109,19109,14610,7429,7181,14610,13608,87,612,,0.931416838,0.005954825,0.041889117,,,
Lee County,Iowa,19,111,19111,33175,16580,16595,33175,30391,924,1134,,0.916081387,0.027852298,0.034182366,,,
Linn County,Iowa,19,113,19113,229463,113411,116052,229463,194149,13344,9120,,0.84610155,0.058153166,0.03974497,,,
Louisa County,Iowa,19,115,19115,10710,5483,5227,10710,8835,67,1730,,0.824929972,0.006255836,0.161531279,,,
Lucas County,Iowa,19,117,19117,8685,4482,4203,8685,8339,17,239,,0.960161197,0.001957398,0.02751871,,,
Lyon County,Iowa,19,119,19119,12087,6175,5912,12087,11429,36,421,,0.945561347,0.002978407,0.03483081,,,
Madison County,Iowa,19,121,19121,16760,8548,8212,16760,16031,211,367,,0.95650358,0.012589499,0.021897375,,,
Mahaska County,Iowa,19,123,19123,22045,11257,10788,22045,20540,338,528,,0.931730551,0.015332275,0.023951009,,,
Marion County,Iowa,19,125,19125,33551,16854,16697,33551,31812,170,748,,0.94816846,0.005066913,0.022294417,,,
Marshall County,Iowa,19,127,19127,39971,20301,19670,39971,29835,777,9518,,0.746416152,0.019439093,0.238122639,,,
Mills County,Iowa,19,129,19129,14563,7240,7323,14563,13742,56,525,,0.943624253,0.003845362,0.036050264,,,
Mitchell County,Iowa,19,131,19131,10548,5246,5302,10548,10206,37,216,,0.967576792,0.003507774,0.020477816,,,
Monona County,Iowa,19,133,19133,8619,4170,4449,8619,8132,13,217,,0.943496925,0.001508296,0.025176935,,,
Monroe County,Iowa,19,135,19135,7546,3799,3747,7546,7189,16,58,,0.952690167,0.002120329,0.007686191,,,
Montgomery County,Iowa,19,137,19137,10254,5026,5228,10254,9566,59,177,,0.932904232,0.005753852,0.017261556,,,
Muscatine County,Iowa,19,139,19139,42735,21442,21293,42735,35076,1247,7878,,0.820779221,0.029179829,0.184345384,,,
O'Brien County,Iowa,19,141,19141,14103,7035,7068,14103,12682,186,1009,,0.899241296,0.013188683,0.071545061,,,
Osceola County,Iowa,19,143,19143,6114,3235,2879,6114,5484,46,618,,0.896957802,0.007523716,0.10107949,,,
Page County,Iowa,19,145,19145,15168,8034,7134,15168,14049,279,498,,0.926226266,0.018393987,0.032832278,,,
Palo Alto County,Iowa,19,147,19147,8902,4468,4434,8902,8239,155,293,,0.925522355,0.017411818,0.032913952,,,
Plymouth County,Iowa,19,149,19149,25699,13092,12607,25699,23270,607,1578,,0.905482704,0.023619596,0.061403167,,,
Pocahontas County,Iowa,19,151,19151,7040,3510,3530,7040,6459,74,383,,0.917471591,0.010511364,0.054403409,,,
Polk County,Iowa,19,153,19153,497441,247187,250254,497441,387043,37411,49816,,0.778068153,0.075206909,0.10014454,,,
Pottawattamie County,Iowa,19,155,19155,93407,46490,46917,93407,83108,1709,8127,,0.889740598,0.018296273,0.087006327,,,
Poweshiek County,Iowa,19,157,19157,18582,9050,9532,18582,17026,234,615,,0.91626305,0.012592832,0.033096545,,,
Ringgold County,Iowa,19,159,19159,4664,2304,2360,4664,4472,9,93,,0.958833619,0.001929674,0.019939966,,,
Sac County,Iowa,19,161,19161,9759,4967,4792,9759,9267,54,398,,0.949584998,0.005533354,0.040782867,,,
Scott County,Iowa,19,163,19163,174302,86114,88188,174302,140647,12444,12512,,0.806915583,0.071393329,0.071783456,,,
Shelby County,Iowa,19,165,19165,11757,5825,5932,11757,10962,55,440,,0.932380709,0.004678064,0.037424513,,,
Sioux County,Iowa,19,167,19167,35984,18052,17932,35984,31594,212,4970,,0.878001334,0.005891507,0.138116941,,,
Story County,Iowa,19,169,19169,98592,51441,47151,98592,81672,2679,4943,,0.828383642,0.02717259,0.050135914,,,
Tama County,Iowa,19,171,19171,16982,8597,8385,16982,13845,196,1919,,0.815274997,0.011541632,0.113002002,,,
Taylor County,Iowa,19,173,19173,5901,2939,2962,5901,5434,7,461,,0.920860871,0.00118624,0.078122352,,,
Union County,Iowa,19,175,19175,12038,5863,6175,12038,11339,55,420,,0.941933876,0.004568865,0.034889517,,,
Van Buren County,Iowa,19,177,19177,7236,3697,3539,7236,6932,15,124,,0.957987839,0.002072968,0.01713654,,,
Wapello County,Iowa,19,179,19179,35265,17921,17344,35265,29147,1191,4457,,0.82651354,0.033772863,0.126385935,,,
Warren County,Iowa,19,181,19181,53484,26586,26898,53484,50153,386,1854,,0.937719692,0.007217112,0.034664573,,,
Washington County,Iowa,19,183,19183,22539,11192,11347,22539,20588,143,1668,,0.913438928,0.006344558,0.074005058,,,
Wayne County,Iowa,19,185,19185,6518,3274,3244,6518,6169,24,84,,0.946455968,0.003682111,0.012887389,,,
Webster County,Iowa,19,187,19187,36848,19289,17559,36848,32035,1163,2217,,0.869382327,0.031562093,0.060166088,,,
Winnebago County,Iowa,19,189,19189,10648,5408,5240,10648,9667,98,616,,0.907870023,0.009203606,0.05785124,,,
Winneshiek County,Iowa,19,191,19191,19972,10109,9863,19972,18844,136,600,,0.943520929,0.006809533,0.030042059,,,
Woodbury County,Iowa,19,193,19193,105760,53040,52720,105760,78375,4813,19487,,0.741064675,0.045508699,0.184256808,,,
Worth County,Iowa,19,195,19195,7380,3827,3553,7380,6986,64,249,,0.946612466,0.008672087,0.033739837,,,
Wright County,Iowa,19,197,19197,12817,6402,6415,12817,10716,23,2402,,0.836077085,0.001794492,0.18740735,,,
Allen County,Kansas,20,001,20001,12491,6164,6327,12491,11374,236,512,,0.910575614,0.018893603,0.040989512,,,
Anderson County,Kansas,20,003,20003,7819,3764,4055,7819,7200,69,127,,0.920833866,0.008824658,0.016242486,,,
Atchison County,Kansas,20,005,20005,16211,7888,8323,16211,14178,698,582,,0.874591327,0.043057183,0.035901548,,,
Barber County,Kansas,20,007,20007,4153,2155,1998,4153,3852,7,254,,0.927522273,0.001685529,0.061160607,,,
Barton County,Kansas,20,009,20009,25275,12392,12883,25275,21132,165,4149,,0.836083086,0.00652819,0.164154303,,,
Bourbon County,Kansas,20,011,20011,14384,7017,7367,14384,13013,319,432,,0.904685762,0.022177419,0.03003337,,,
Brown County,Kansas,20,013,20013,9415,4671,4744,9415,7839,131,416,,0.832607541,0.013913967,0.044184811,,,
Butler County,Kansas,20,015,20015,67916,34483,33433,67916,59969,1517,3813,,0.882987808,0.022336416,0.056142882,,,
Chase County,Kansas,20,017,20017,2579,1330,1249,2579,2296,32,208,,0.890267546,0.01240791,0.080651415,,,
Chautauqua County,Kansas,20,019,20019,3370,1794,1576,3370,2806,32,161,,0.83264095,0.009495549,0.047774481,,,
Cherokee County,Kansas,20,021,20021,19236,9502,9734,19236,16853,158,548,,0.876117696,0.008213766,0.028488251,,,
Cheyenne County,Kansas,20,023,20023,2628,1377,1251,2628,2328,1,239,,0.885844749,0.000380518,0.090943683,,,
Clark County,Kansas,20,025,20025,1987,1009,978,1987,1694,0,127,,0.85254152,0,0.06391545,,,
Clay County,Kansas,20,027,20027,8071,4057,4014,8071,7614,189,264,,0.943377524,0.023417173,0.032709701,,,
Cloud County,Kansas,20,029,20029,8973,4616,4357,8973,8262,70,332,,0.920762287,0.007801181,0.036999889,,,
Coffey County,Kansas,20,031,20031,8304,4134,4170,8304,7779,42,279,,0.936777457,0.005057803,0.033598266,,,
Comanche County,Kansas,20,033,20033,1685,818,867,1685,1626,5,31,,0.964985163,0.002967359,0.018397626,,,
Cowley County,Kansas,20,035,20035,34487,17552,16935,34487,28496,791,4098,,0.826282367,0.022936179,0.118827384,,,
Crawford County,Kansas,20,037,20037,38963,19635,19328,38963,34476,862,2769,,0.884839463,0.022123553,0.071067423,,,
Decatur County,Kansas,20,039,20039,2746,1431,1315,2746,2545,47,112,,0.926802622,0.017115805,0.040786599,,,
Dickinson County,Kansas,20,041,20041,18423,9212,9211,18423,16916,51,998,,0.918200076,0.002768279,0.054171416,,,
Doniphan County,Kansas,20,043,20043,7492,3849,3643,7492,6798,229,237,,0.907367859,0.030565937,0.031633743,,,
Douglas County,Kansas,20,045,20045,119547,59563,59984,119547,94630,5036,8443,,0.791571516,0.042125691,0.070624942,,,
Edwards County,Kansas,20,047,20047,2817,1469,1348,2817,2339,4,621,,0.830315939,0.00141995,0.220447284,,,
Elk County,Kansas,20,049,20049,2464,1241,1223,2464,2238,3,110,,0.908279221,0.001217532,0.044642857,,,
Ellis County,Kansas,20,051,20051,28870,14478,14392,28870,26026,520,2039,,0.901489435,0.018011777,0.070626948,,,
Ellsworth County,Kansas,20,053,20053,6366,3506,2860,6366,5528,200,385,,0.868363179,0.031416902,0.060477537,,,
Finney County,Kansas,20,055,20055,38001,19524,18477,38001,20345,1696,19915,,0.535380648,0.044630404,0.524065156,,,
Ford County,Kansas,20,057,20057,34133,17839,16294,34133,19216,1067,19858,,0.562974248,0.031260071,0.581783025,,,
Franklin County,Kansas,20,059,20059,25994,12970,13024,25994,23685,232,1215,,0.911171809,0.008925137,0.046741556,,,
Geary County,Kansas,20,061,20061,35895,18876,17019,35895,21734,5828,5811,,0.60548823,0.162362446,0.161888842,,,
Gove County,Kansas,20,063,20063,2796,1385,1411,2796,2672,6,37,,0.95565093,0.002145923,0.01323319,,,
Graham County,Kansas,20,065,20065,2406,1191,1215,2406,2188,90,90,,0.909393184,0.037406484,0.037406484,,,
Grant County,Kansas,20,067,20067,7284,4077,3207,7284,4825,13,3850,,0.662410763,0.001784734,0.528555739,,,
Gray County,Kansas,20,069,20069,5696,2882,2814,5696,5252,0,915,,0.922050562,0,0.160639045,,,
Greeley County,Kansas,20,071,20071,1296,624,672,1296,1140,2,225,,0.87962963,0.00154321,0.173611111,,,
Greenwood County,Kansas,20,073,20073,5956,3031,2925,5956,5535,35,235,,0.929314976,0.005876427,0.039456011,,,
Hamilton County,Kansas,20,075,20075,2485,1240,1245,2485,1665,1,1034,,0.670020121,0.000402414,0.416096579,,,
Harper County,Kansas,20,077,20077,5446,2714,2732,5446,4938,46,421,,0.906720529,0.008446566,0.077304444,,,
Harvey County,Kansas,20,079,20079,33823,16661,17162,33823,28858,372,4104,,0.853206398,0.010998433,0.121337551,,,
Haskell County,Kansas,20,081,20081,3695,1846,1849,3695,2620,9,1112,,0.709066306,0.002435724,0.300947226,,,
Hodgeman County,Kansas,20,083,20083,1676,796,880,1676,1596,2,96,,0.952267303,0.001193317,0.057279236,,,
Jackson County,Kansas,20,085,20085,13277,6768,6509,13277,11225,124,705,,0.845447014,0.009339459,0.053099345,,,
Jefferson County,Kansas,20,087,20087,18391,9292,9099,18391,17141,132,616,,0.932031972,0.007177424,0.033494644,,,
Jewell County,Kansas,20,089,20089,2909,1496,1413,2909,2708,23,76,,0.930904091,0.007906497,0.026125816,,,
Johnson County,Kansas,20,091,20091,614764,303861,310903,614764,492994,29984,55724,,0.80192399,0.048773188,0.090642913,,,
Kearny County,Kansas,20,093,20093,3910,2037,1873,3910,2944,47,1379,,0.752941176,0.01202046,0.352685422,,,
Kingman County,Kansas,20,095,20095,7284,3708,3576,7284,6778,19,289,,0.930532674,0.002608457,0.039676002,,,
Kiowa County,Kansas,20,097,20097,2422,1183,1239,2422,2187,20,104,,0.90297275,0.008257638,0.042939719,,,
Labette County,Kansas,20,099,20099,19949,10173,9776,19949,17002,686,998,,0.852273297,0.034387689,0.05002757,,,
Lane County,Kansas,20,101,20101,1497,766,731,1497,1349,5,231,,0.901135605,0.003340013,0.154308617,,,
Leavenworth County,Kansas,20,103,20103,82493,43965,38528,82493,66371,6093,6027,,0.804565236,0.073860812,0.073060745,,,
Lincoln County,Kansas,20,105,20105,2924,1488,1436,2924,2746,6,123,,0.939124487,0.002051984,0.042065663,,,
Linn County,Kansas,20,107,20107,9723,5020,4703,9723,9105,74,284,,0.936439371,0.00761082,0.029209092,,,
Logan County,Kansas,20,109,20109,2720,1446,1274,2720,2469,0,185,,0.907720588,0,0.068014706,,,
Lyon County,Kansas,20,111,20111,32145,15714,16431,32145,24112,509,7526,,0.750101104,0.0158345,0.234126614,,,
McPherson County,Kansas,20,113,20113,30130,14945,15185,30130,28018,518,1635,,0.92990375,0.017192167,0.054264852,,,
Marion County,Kansas,20,115,20115,11795,6002,5793,11795,11004,136,480,,0.932937685,0.011530309,0.04069521,,,
Marshall County,Kansas,20,117,20117,10001,5080,4921,10001,9488,66,262,,0.948705129,0.00659934,0.02619738,,,
Meade County,Kansas,20,119,20119,3949,1987,1962,3949,3184,51,915,,0.806280071,0.012914662,0.231704229,,,
Miami County,Kansas,20,121,20121,34625,17268,17357,34625,31845,395,1334,,0.919711191,0.011407942,0.038527076,,,
Mitchell County,Kansas,20,123,20123,5767,2974,2793,5767,5418,11,118,,0.939483267,0.001907404,0.020461245,,,
Montgomery County,Kansas,20,125,20125,31143,15451,15692,31143,24725,1336,2428,,0.793918377,0.042898886,0.077962945,,,
Morris County,Kansas,20,127,20127,5388,2761,2627,5388,5002,12,237,,0.928359317,0.002227171,0.043986637,,,
Morton County,Kansas,20,129,20129,2647,1197,1450,2647,2067,35,613,,0.78088402,0.013222516,0.231582924,,,
Nemaha County,Kansas,20,131,20131,10213,5259,4954,10213,9698,65,257,,0.949574072,0.006364437,0.025164007,,,
Neosho County,Kansas,20,133,20133,15715,7815,7900,15715,14432,222,930,,0.918358256,0.014126631,0.059179128,,,
Ness County,Kansas,20,135,20135,2659,1375,1284,2659,2144,1,403,,0.806318165,0.000376081,0.151560737,,,
Norton County,Kansas,20,137,20137,5392,2970,2422,5392,4833,146,314,,0.896327893,0.027077151,0.058234421,,,
Osage County,Kansas,20,139,20139,15780,8019,7761,15780,14778,79,512,,0.936501901,0.005006337,0.032446134,,,
Osborne County,Kansas,20,141,20141,3473,1744,1729,3473,3228,14,93,,0.929455802,0.004031097,0.026778002,,,
Ottawa County,Kansas,20,143,20143,5782,3031,2751,5782,5415,40,183,,0.936527153,0.006918021,0.031649948,,,
Pawnee County,Kansas,20,145,20145,6220,3363,2857,6220,5442,426,540,,0.874919614,0.068488746,0.08681672,,,
Phillips County,Kansas,20,147,20147,4874,2495,2379,4874,4589,26,160,,0.941526467,0.005334428,0.032827247,,,
Pottawatomie County,Kansas,20,149,20149,25808,12940,12868,25808,23262,450,1508,,0.901348419,0.017436454,0.058431494,,,
Pratt County,Kansas,20,151,20151,9120,4634,4486,9120,8102,189,755,,0.888377193,0.020723684,0.082785088,,,
Rawlins County,Kansas,20,153,20153,2533,1323,1210,2533,2371,0,186,,0.936044216,0,0.073430715,,,
Reno County,Kansas,20,155,20155,61693,31252,30441,61693,53674,1416,6245,,0.870017668,0.022952361,0.101227044,,,
Republic County,Kansas,20,157,20157,4662,2298,2364,4662,4430,29,116,,0.95023595,0.006220506,0.024882025,,,
Rice County,Kansas,20,159,20159,9389,4851,4538,9389,7556,176,1282,,0.804771541,0.01874534,0.136542763,,,
Riley County,Kansas,20,161,20161,71710,38159,33551,71710,55831,4552,7120,,0.778566448,0.063477897,0.099288802,,,
Rooks County,Kansas,20,163,20163,4869,2404,2465,4869,4523,132,144,,0.92893818,0.02711029,0.029574861,,,
Rush County,Kansas,20,165,20165,2957,1568,1389,2957,2674,13,160,,0.904294893,0.004396348,0.054108894,,,
Russell County,Kansas,20,167,20167,6717,3363,3354,6717,6069,0,271,,0.903528361,0,0.040345392,,,
Saline County,Kansas,20,169,20169,53801,26709,27092,53801,45603,2005,6715,,0.84762365,0.037266965,0.124811806,,,
Scott County,Kansas,20,171,20171,5071,2604,2467,5071,4295,0,1024,,0.846972984,0,0.201932558,,,
Sedgwick County,Kansas,20,173,20173,524810,260740,264070,524810,373534,41654,84671,,0.711750919,0.079369677,0.161336484,,,
Seward County,Kansas,20,175,20175,21640,11362,10278,21640,8764,587,14418,,0.404990758,0.027125693,0.666266174,,,
Shawnee County,Kansas,20,177,20177,178315,86786,91529,178315,135645,13598,24244,,0.760704371,0.076258307,0.135961641,,,
Sheridan County,Kansas,20,179,20179,2442,1234,1208,2442,2273,3,145,,0.930794431,0.001228501,0.059377559,,,
Sherman County,Kansas,20,181,20181,5919,3160,2759,5919,4833,231,766,,0.816523061,0.039026863,0.129413752,,,
Smith County,Kansas,20,183,20183,3579,1829,1750,3579,3370,27,40,,0.9416038,0.007544007,0.011176306,,,
Stafford County,Kansas,20,185,20185,4004,2055,1949,4004,3470,8,534,,0.866633367,0.001998002,0.133366633,,,
Stanton County,Kansas,20,187,20187,2018,1034,984,2018,1483,0,908,,0.734886026,0,0.449950446,,,
Stevens County,Kansas,20,189,20189,5212,2823,2389,5212,3548,6,2016,,0.680736761,0.00115119,0.386799693,,,
Sumner County,Kansas,20,191,20191,22386,11307,11079,22386,20125,255,1320,,0.898999375,0.011391048,0.058965425,,,
Thomas County,Kansas,20,193,20193,7913,4021,3892,7913,7321,104,639,,0.925186402,0.013142929,0.080753191,,,
Trego County,Kansas,20,195,20195,2778,1371,1407,2778,2670,2,5,,0.96112311,0.000719942,0.001799856,,,
Wabaunsee County,Kansas,20,197,20197,6961,3564,3397,6961,6393,22,322,,0.918402528,0.003160465,0.046257722,,,
Wallace County,Kansas,20,199,20199,1459,735,724,1459,1325,10,91,,0.908156271,0.00685401,0.062371487,,,
Washington County,Kansas,20,201,20201,5519,2861,2658,5519,5127,11,258,,0.92897264,0.001993115,0.046747599,,,
Wichita County,Kansas,20,203,20203,2115,1147,968,2115,1588,4,628,,0.750827423,0.001891253,0.296926714,,,
Wilson County,Kansas,20,205,20205,8559,4334,4225,8559,8020,15,310,,0.937025353,0.001752541,0.036219184,,,
Woodson County,Kansas,20,207,20207,3118,1590,1528,3118,2889,3,23,,0.926555484,0.000962155,0.007376523,,,
Wyandotte County,Kansas,20,209,20209,167277,84181,83096,167277,77767,32213,55765,,0.464899538,0.192572798,0.333369202,,,
Adair County,Kentucky,21,001,21001,19016,9555,9461,19016,17366,342,626,,0.913230963,0.017984855,0.032919647,,,
Allen County,Kentucky,21,003,21003,21029,10415,10614,21029,20055,107,584,,0.953683009,0.005088212,0.027771173,,,
Anderson County,Kentucky,21,005,21005,24098,12190,11908,24098,22461,679,578,,0.932069051,0.028176612,0.023985393,,,
Ballard County,Kentucky,21,007,21007,7678,3894,3784,7678,7065,279,110,,0.9201615,0.036337588,0.014326648,,,
Barren County,Kentucky,21,009,21009,44670,21774,22896,44670,39673,1652,1904,,0.888135214,0.036982315,0.042623685,,,
Bath County,Kentucky,21,011,21011,12812,6513,6299,12812,12233,225,227,,0.954807993,0.017561661,0.017717765,,,
Bell County,Kentucky,21,013,21013,23878,11932,11946,23878,22302,533,177,,0.933997822,0.022321802,0.007412681,,,
Boone County,Kentucky,21,015,21015,137676,68666,69010,137676,117478,5240,7827,,0.853293239,0.038060374,0.056850867,,,
Bourbon County,Kentucky,21,017,21017,20174,10036,10138,20174,17377,964,1523,,0.861356201,0.047784277,0.075493209,,,
Boyd County,Kentucky,21,019,21019,48043,24059,23984,48043,44676,1029,816,,0.929916949,0.021418313,0.016984784,,,
Boyle County,Kentucky,21,021,21021,30708,15534,15174,30708,25833,2323,1438,,0.841246581,0.07564804,0.046828188,,,
Bracken County,Kentucky,21,023,21023,8427,4249,4178,8427,8039,102,78,,0.953957518,0.012103952,0.009255963,,,
Breathitt County,Kentucky,21,025,21025,13438,6733,6705,13438,12967,73,155,,0.964950141,0.005432356,0.011534455,,,
Breckinridge County,Kentucky,21,027,21027,20722,10367,10355,20722,19564,341,327,,0.944117363,0.016455941,0.01578033,,,
Bullitt County,Kentucky,21,029,21029,83209,41554,41655,83209,76770,1019,2401,,0.922616544,0.012246271,0.028855052,,,
Butler County,Kentucky,21,031,21031,12373,6385,5988,12373,11629,27,616,,0.93986907,0.002182171,0.049785824,,,
Caldwell County,Kentucky,21,033,21033,12631,6218,6413,12631,11494,627,299,,0.909983374,0.049639775,0.023671918,,,
Calloway County,Kentucky,21,035,21035,37882,18432,19450,37882,33898,1428,1314,,0.894831318,0.037696003,0.034686659,,,
Campbell County,Kentucky,21,037,21037,93193,46164,47029,93193,85245,2596,2362,,0.914714624,0.027856169,0.025345251,,,
Carlisle County,Kentucky,21,039,21039,4763,2424,2339,4763,4400,67,133,,0.923787529,0.014066765,0.027923578,,,
Carroll County,Kentucky,21,041,21041,10878,5468,5410,10878,9465,255,796,,0.870104799,0.023441809,0.073175216,,,
Carter County,Kentucky,21,043,21043,26515,13065,13450,26515,25357,120,289,,0.956326608,0.00452574,0.010899491,,,
Casey County,Kentucky,21,045,21045,15951,7730,8221,15951,15269,84,532,,0.95724406,0.005266128,0.033352141,,,
Christian County,Kentucky,21,047,21047,72599,38091,34508,72599,49182,14017,6120,,0.677447348,0.193074285,0.084298682,,,
Clark County,Kentucky,21,049,21049,37004,17957,19047,37004,33201,1575,1493,,0.897227327,0.042562966,0.04034699,,,
Clay County,Kentucky,21,051,21051,20105,10533,9572,20105,18535,938,244,,0.921909973,0.046655061,0.012136285,,,
Clinton County,Kentucky,21,053,21053,9240,4567,4673,9240,8776,0,280,,0.94978355,0,0.03030303,,,
Crittenden County,Kentucky,21,055,21055,8972,4631,4341,8972,8632,46,216,,0.962104325,0.005127062,0.0240749,,,
Cumberland County,Kentucky,21,057,21057,5948,2939,3009,5948,5538,98,107,,0.931069267,0.016476126,0.01798924,,,
Daviess County,Kentucky,21,059,21059,103195,50437,52758,103195,89515,4516,4175,,0.867435438,0.04376181,0.040457387,,,
Edmonson County,Kentucky,21,061,21061,12243,6031,6212,12243,11621,82,195,,0.949195459,0.006697705,0.015927469,,,
Elliott County,Kentucky,21,063,21063,7336,4220,3116,7336,6871,221,148,,0.936613959,0.030125409,0.020174482,,,
Estill County,Kentucky,21,065,21065,14079,7005,7074,14079,13569,16,131,,0.963775836,0.001136444,0.009304638,,,
Fayette County,Kentucky,21,067,21067,321122,158152,162970,321122,224558,46225,29571,,0.699291858,0.143948406,0.092086497,,,
Fleming County,Kentucky,21,069,21069,15221,7571,7650,15221,14471,166,238,,0.950725971,0.010905985,0.015636292,,,
Floyd County,Kentucky,21,071,21071,35342,17386,17956,35342,34138,223,330,,0.965932884,0.006309773,0.009337332,,,
Franklin County,Kentucky,21,073,21073,51563,24981,26582,51563,42132,4757,2109,,0.817097531,0.092256075,0.040901422,,,
Fulton County,Kentucky,21,075,21075,6440,3304,3136,6440,4485,1568,86,,0.696428571,0.243478261,0.013354037,,,
Gallatin County,Kentucky,21,077,21077,8749,4489,4260,8749,7791,238,472,,0.890501772,0.027203109,0.053949023,,,
Garrard County,Kentucky,21,079,21079,17346,8505,8841,17346,16044,384,468,,0.924939467,0.022137669,0.026980284,,,
Grant County,Kentucky,21,081,21081,25238,12763,12475,25238,23431,208,799,,0.928401617,0.008241541,0.03165861,,,
Graves County,Kentucky,21,083,21083,36612,18109,18503,36612,31666,1493,2838,,0.864907681,0.04077898,0.077515569,,,
Grayson County,Kentucky,21,085,21085,26586,13414,13172,26586,25477,264,409,,0.958286316,0.009930038,0.015384037,,,
Green County,Kentucky,21,087,21087,11278,5674,5604,11278,10814,136,260,,0.958857954,0.012058876,0.023053733,,,
Greenup County,Kentucky,21,089,21089,35639,17470,18169,35639,34004,210,386,,0.954123292,0.005892421,0.010830831,,,
Hancock County,Kentucky,21,091,21091,9032,4518,4514,9032,8535,100,63,,0.944973428,0.011071745,0.006975199,,,
Hardin County,Kentucky,21,093,21093,111452,55287,56165,111452,85453,12926,7007,,0.766724689,0.115978179,0.062870114,,,
Harlan County,Kentucky,21,095,21095,26185,12612,13573,26185,24696,387,40,,0.943135383,0.014779454,0.001527592,,,
Harrison County,Kentucky,21,097,21097,18971,9234,9737,18971,17842,354,420,,0.940488113,0.01866006,0.022139054,,,
Hart County,Kentucky,21,099,21099,19470,9632,9838,19470,17784,897,384,,0.913405239,0.046070878,0.01972265,,,
Henderson County,Kentucky,21,101,21101,44493,21707,22786,44493,38187,3032,1436,,0.85826984,0.068145551,0.03227474,,,
Henry County,Kentucky,21,103,21103,15774,7895,7879,15774,14360,425,606,,0.910358818,0.026943071,0.038417649,,,
Hickman County,Kentucky,21,105,21105,4470,2169,2301,4470,3863,412,108,,0.864205817,0.092170022,0.024161074,,,
Hopkins County,Kentucky,21,107,21107,45143,21906,23237,45143,39706,2758,1140,,0.879560508,0.061094743,0.025253085,,,
Jackson County,Kentucky,21,109,21109,13003,6397,6606,13003,12604,30,125,,0.969314774,0.00230716,0.009613166,,,
Jefferson County,Kentucky,21,111,21111,777392,378058,399334,777392,507893,170727,60873,,0.653329337,0.219615072,0.078304125,,,
Jessamine County,Kentucky,21,113,21113,53792,26258,27534,53792,47460,2135,2467,,0.882287329,0.039689917,0.045861838,,,
Johnson County,Kentucky,21,115,21115,22464,11177,11287,22464,21423,126,120,,0.953659188,0.005608974,0.00534188,,,
Kenton County,Kentucky,21,117,21117,169817,84489,85328,169817,147989,7120,7758,,0.871461632,0.041927487,0.045684472,,,
Knott County,Kentucky,21,119,21119,14046,6975,7071,14046,13576,139,120,,0.966538516,0.009896056,0.008543358,,,
Knox County,Kentucky,21,121,21121,30034,14565,15469,30034,28754,252,365,,0.957381634,0.008390491,0.012152893,,,
Larue County,Kentucky,21,123,21123,15028,7444,7584,15028,13721,331,495,,0.913029013,0.022025552,0.032938515,,,
Laurel County,Kentucky,21,125,21125,62731,31012,31719,62731,60107,297,1039,,0.958170601,0.004734501,0.016562784,,,
Lawrence County,Kentucky,21,127,21127,16171,7939,8232,16171,15742,8,105,,0.973471028,0.000494713,0.006493105,,,
Lee County,Kentucky,21,129,21129,7375,4214,3161,7375,6970,158,72,,0.945084746,0.021423729,0.009762712,,,
Leslie County,Kentucky,21,131,21131,10261,5117,5144,10261,9946,54,51,,0.969301238,0.005262645,0.004970276,,,
Letcher County,Kentucky,21,133,21133,21146,10548,10598,21146,20573,157,159,,0.972902677,0.007424572,0.007519153,,,
Lewis County,Kentucky,21,135,21135,13028,6492,6536,13028,12641,4,11,,0.97029475,0.000307031,0.000844335,,,
Lincoln County,Kentucky,21,137,21137,24415,11983,12432,24415,22717,409,498,,0.930452591,0.016751997,0.020397297,,,
Livingston County,Kentucky,21,139,21139,8941,4427,4514,8941,8551,30,218,,0.956380718,0.003355329,0.02438206,,,
Logan County,Kentucky,21,141,21141,27731,13639,14092,27731,24799,1277,937,,0.894269951,0.046049547,0.033788901,,,
Lyon County,Kentucky,21,143,21143,8831,5031,3800,8831,7819,609,94,,0.885403692,0.068961613,0.010644321,,,
McCracken County,Kentucky,21,145,21145,67584,32587,34997,67584,55784,6730,2210,,0.825402462,0.099579782,0.032700047,,,
McCreary County,Kentucky,21,147,21147,16905,9219,7686,16905,15233,1160,296,,0.901094351,0.068618752,0.017509613,,,
McLean County,Kentucky,21,149,21149,9127,4607,4520,9127,8741,69,186,,0.9577079,0.007559987,0.020379095,,,
Madison County,Kentucky,21,151,21151,94064,46032,48032,94064,84077,3333,3180,,0.893827607,0.035433322,0.03380677,,,
Magoffin County,Kentucky,21,153,21153,11495,5818,5677,11495,11277,6,150,,0.981035233,0.000521966,0.013049152,,,
Marion County,Kentucky,21,155,21155,19680,9772,9908,19680,17356,1415,696,,0.881910569,0.071900407,0.035365854,,,
Marshall County,Kentucky,21,157,21157,31728,15796,15932,31728,30515,229,600,,0.961768785,0.0072176,0.018910741,,,
Martin County,Kentucky,21,159,21159,11181,6248,4933,11181,9836,834,213,,0.879706645,0.074590824,0.019050174,,,
Mason County,Kentucky,21,161,21161,16995,8363,8632,16995,14854,1052,384,,0.874021771,0.061900559,0.022594881,,,
Meade County,Kentucky,21,163,21163,30032,15155,14877,30032,27024,1052,1213,,0.89984017,0.035029302,0.04039025,,,
Menifee County,Kentucky,21,165,21165,6203,3243,2960,6203,6025,15,154,,0.971304208,0.002418185,0.024826697,,,
Mercer County,Kentucky,21,167,21167,22824,11401,11423,22824,20803,813,730,,0.911452857,0.0356204,0.031983877,,,
Metcalfe County,Kentucky,21,169,21169,10372,5162,5210,10372,9761,229,233,,0.9410914,0.022078673,0.022464327,,,
Monroe County,Kentucky,21,171,21171,11318,5681,5637,11318,10589,292,500,,0.935589327,0.025799611,0.044177417,,,
Montgomery County,Kentucky,21,173,21173,28271,13722,14549,28271,26140,749,942,,0.924622405,0.02649358,0.033320364,,,
Morgan County,Kentucky,21,175,21175,13938,8044,5894,13938,12593,570,440,,0.90350122,0.040895394,0.031568374,,,
Muhlenberg County,Kentucky,21,177,21177,30712,15656,15056,30712,28395,647,595,,0.924557176,0.021066684,0.019373535,,,
Nelson County,Kentucky,21,179,21179,47102,23594,23508,47102,42762,2478,1278,,0.907859539,0.052609231,0.027132606,,,
Nicholas County,Kentucky,21,181,21181,7655,3854,3801,7655,7393,76,78,,0.965774004,0.009928152,0.010189419,,,
Ohio County,Kentucky,21,183,21183,23704,11762,11942,23704,21971,256,1007,,0.926889976,0.010799865,0.042482281,,,
Oldham County,Kentucky,21,185,21185,68600,35968,32632,68600,60073,2545,3301,,0.875699708,0.037099125,0.048119534,,,
Owen County,Kentucky,21,187,21187,11270,5787,5483,11270,10628,41,278,,0.943034605,0.003637977,0.024667258,,,
Owsley County,Kentucky,21,189,21189,4021,2053,1968,4021,3751,0,0,,0.932852524,0,0,,,
Pendleton County,Kentucky,21,191,21191,14683,7528,7155,14683,13670,109,230,,0.931008649,0.007423551,0.015664374,,,
Perry County,Kentucky,21,193,21193,27847,13758,14089,27847,26274,276,90,,0.943512766,0.009911301,0.003231946,,,
Pike County,Kentucky,21,195,21195,57466,28367,29099,57466,54669,353,701,,0.951327742,0.006142763,0.012198517,,,
Powell County,Kentucky,21,197,21197,13057,6580,6477,13057,12250,224,179,,0.938194072,0.017155549,0.013709122,,,
Pulaski County,Kentucky,21,199,21199,65503,32245,33258,65503,61935,574,1948,,0.945529212,0.008762957,0.029739096,,,
Robertson County,Kentucky,21,201,21201,2239,937,1302,2239,2127,46,15,,0.949977669,0.020544886,0.006699419,,,
Rockcastle County,Kentucky,21,203,21203,16144,7969,8175,16144,15588,101,190,,0.96555996,0.006256194,0.011769078,,,
Rowan County,Kentucky,21,205,21205,24525,11875,12650,24525,23364,451,543,,0.95266055,0.018389399,0.022140673,,,
Russell County,Kentucky,21,207,21207,18117,8935,9182,18117,16819,175,791,,0.928354584,0.009659436,0.04366065,,,
Scott County,Kentucky,21,209,21209,58269,28787,29482,58269,49978,2820,3192,,0.857711648,0.048396231,0.054780415,,,
Shelby County,Kentucky,21,211,21211,48599,23953,24646,48599,39507,2308,5239,,0.812917961,0.047490689,0.107800572,,,
Simpson County,Kentucky,21,213,21213,19786,9881,9905,19786,16718,1386,679,,0.844940867,0.07004953,0.034317194,,,
Spencer County,Kentucky,21,215,21215,19875,10011,9864,19875,18752,191,510,,0.943496855,0.009610063,0.025660377,,,
Taylor County,Kentucky,21,217,21217,26205,12886,13319,26205,23588,1205,753,,0.900133562,0.045983591,0.028734974,,,
Todd County,Kentucky,21,219,21219,12330,6239,6091,12330,10565,888,624,,0.856853204,0.072019465,0.050608273,,,
Trigg County,Kentucky,21,221,21221,14211,7073,7138,14211,12401,913,366,,0.872633875,0.064246007,0.025754697,,,
Trimble County,Kentucky,21,223,21223,8531,4249,4282,8531,7980,70,234,,0.935412027,0.008205369,0.027429375,,,
Union County,Kentucky,21,225,21225,13379,6771,6608,13379,11896,1084,220,,0.889154645,0.081022498,0.01644368,,,
Warren County,Kentucky,21,227,21227,137549,67854,69695,137549,106831,11890,9543,,0.776675948,0.086441923,0.069378912,,,
Washington County,Kentucky,21,229,21229,12091,5971,6120,12091,10649,629,55,,0.880737739,0.052022165,0.004548838,,,
Wayne County,Kentucky,21,231,21231,19592,9612,9980,19592,18101,266,861,,0.923897509,0.01357697,0.043946509,,,
Webster County,Kentucky,21,233,21233,12873,6433,6440,12873,11405,549,841,,0.885962868,0.042647402,0.065330537,,,
Whitley County,Kentucky,21,235,21235,36755,18067,18688,36755,35204,391,712,,0.95780166,0.010638008,0.019371514,,,
Wolfe County,Kentucky,21,237,21237,6484,3225,3259,6484,6231,14,102,,0.960980876,0.002159161,0.01573103,,,
Woodford County,Kentucky,21,239,21239,27017,12829,14188,27017,23720,1086,1983,,0.877965725,0.040196913,0.073398231,,,
Acadia Parish,Louisiana,22,001,22001,57218,27948,29270,57218,44296,8983,1802,,0.774161977,0.15699605,0.031493586,,,
Allen Parish,Louisiana,22,003,22003,22552,13248,9304,22552,15815,4408,1803,,0.70126818,0.195459383,0.079948563,,,
Ascension Parish,Louisiana,22,005,22005,128593,63537,65056,128593,83999,29501,10477,,0.65321596,0.229413732,0.081474108,,,
Assumption Parish,Louisiana,22,007,22007,20720,9888,10832,20720,13574,5927,860,,0.65511583,0.286052124,0.041505792,,,
Avoyelles Parish,Louisiana,22,009,22009,39176,19574,19602,39176,25196,10399,1494,,0.643148867,0.265443128,0.038135593,,,
Beauregard Parish,Louisiana,22,011,22011,36646,18787,17859,36646,29368,4018,1396,,0.801397151,0.109643617,0.038094199,,,
Bienville Parish,Louisiana,22,013,22013,12769,6109,6660,12769,6934,5285,256,,0.54303391,0.413893022,0.020048555,,,
Bossier Parish,Louisiana,22,015,22015,129134,64136,64998,129134,84086,30797,10328,,0.651153066,0.238488702,0.079978937,,,
Caddo Parish,Louisiana,22,017,22017,232973,110313,122660,232973,101983,114340,8531,,0.437746005,0.490786486,0.036617977,,,
Calcasieu Parish,Louisiana,22,019,22019,208668,102219,106449,208668,139728,49440,10805,,0.669618724,0.236931393,0.051780819,,,
Caldwell Parish,Louisiana,22,021,22021,9563,5088,4475,9563,7442,1737,253,,0.778207675,0.181637561,0.026456133,,,
Cameron Parish,Louisiana,22,023,22023,5222,2656,2566,5222,4473,63,10,,0.856568365,0.012064343,0.001914975,,,
Catahoula Parish,Louisiana,22,025,22025,8738,4639,4099,8738,5547,3032,94,,0.634813458,0.346990158,0.01075761,,,
Claiborne Parish,Louisiana,22,027,22027,14019,7568,6451,14019,6293,6835,471,,0.448890791,0.487552607,0.033597261,,,
Concordia Parish,Louisiana,22,029,22029,18325,9128,9197,18325,10443,7135,465,,0.569877217,0.389358799,0.025375171,,,
De Soto Parish,Louisiana,22,031,22031,26897,13041,13856,26897,16218,9421,828,,0.602966874,0.350262111,0.030784102,,,
East Baton Rouge Parish,Louisiana,22,033,22033,452821,216535,236286,452821,195656,200404,29827,,0.432082434,0.442567814,0.065869295,,,
East Carroll Parish,Louisiana,22,035,22035,7195,4144,3051,7195,2115,4671,144,,0.293954135,0.649200834,0.020013899,,,
East Feliciana Parish,Louisiana,22,037,22037,19378,10737,8641,19378,10609,7734,379,,0.54747652,0.399112396,0.019558262,,,
Evangeline Parish,Louisiana,22,039,22039,32162,16259,15903,32162,21123,8256,1428,,0.656768858,0.256700454,0.044400224,,,
Franklin Parish,Louisiana,22,041,22041,19590,9367,10223,19590,13048,5620,320,,0.666054109,0.286881062,0.016334865,,,
Grant Parish,Louisiana,22,043,22043,22123,12484,9639,22123,17302,3276,1336,,0.782081996,0.148081182,0.06038964,,,
Iberia Parish,Louisiana,22,045,22045,69194,34176,35018,69194,39620,21262,3810,,0.572592999,0.307280978,0.055062578,,,
Iberville Parish,Louisiana,22,047,22047,29950,15189,14761,29950,14444,13554,1440,,0.482270451,0.452554257,0.048080134,,,
Jackson Parish,Louisiana,22,049,22049,14939,7593,7346,14939,9999,3813,486,,0.669321909,0.255237968,0.032532298,,,
Jefferson Parish,Louisiana,22,051,22051,432484,210211,222273,432484,227711,112620,78562,,0.5265189,0.260402697,0.181652963,,,
Jefferson Davis Parish,Louisiana,22,053,22053,32083,15831,16252,32083,24802,4710,783,,0.773057382,0.14680672,0.024405448,,,
Lafayette Parish,Louisiana,22,055,22055,245075,119760,125315,245075,156910,62153,15847,,0.640252984,0.253608079,0.064661838,,,
Lafourche Parish,Louisiana,22,057,22057,96670,47658,49012,96670,73818,12728,5562,,0.763608151,0.131664425,0.057535947,,,
LaSalle Parish,Louisiana,22,059,22059,14804,8133,6671,14804,11965,1680,1315,,0.808227506,0.113482842,0.088827344,,,
Lincoln Parish,Louisiana,22,061,22061,48160,23707,24453,48160,25832,17815,1753,,0.536378738,0.369912791,0.036399502,,,
Livingston Parish,Louisiana,22,063,22063,145583,71923,73660,145583,121221,12013,9095,,0.832659033,0.082516503,0.062472954,,,
Madison Parish,Louisiana,22,065,22065,9757,4765,4992,9757,3301,6140,239,,0.338321205,0.629291791,0.024495234,,,
Morehouse Parish,Louisiana,22,067,22067,24967,12198,12769,24967,11947,12016,405,,0.478511635,0.481275283,0.016221412,,,
Natchitoches Parish,Louisiana,22,069,22069,37047,17773,19274,37047,18885,14810,1434,,0.509757875,0.399762464,0.038707588,,,
Orleans Parish,Louisiana,22,071,22071,376035,177299,198736,376035,118979,207633,29855,,0.316404058,0.552164027,0.079394205,,,
Ouachita Parish,Louisiana,22,073,22073,158916,76494,82422,158916,90108,58926,5668,,0.567016537,0.370799668,0.035666641,,,
Plaquemines Parish,Louisiana,22,075,22075,23070,12049,11021,23070,14254,5157,2193,,0.617858691,0.223537061,0.095058518,,,
Pointe Coupee Parish,Louisiana,22,077,22077,20438,10074,10364,20438,12512,6604,676,,0.612192974,0.323123593,0.033075643,,,
Rapides Parish,Louisiana,22,079,22079,128470,62286,66184,128470,78676,39926,5178,,0.612407566,0.310780727,0.04030513,,,
Red River Parish,Louisiana,22,081,22081,7529,3763,3766,7529,4319,3027,133,,0.573648559,0.402045424,0.017665029,,,
Richland Parish,Louisiana,22,083,22083,19908,9855,10053,19908,12062,7188,434,,0.605887081,0.36106088,0.021800281,,,
Sabine Parish,Louisiana,22,085,22085,22085,10963,11122,22085,14846,3171,761,,0.672220964,0.143581616,0.034457777,,,
St. Bernard Parish,Louisiana,22,087,22087,44172,21640,22532,44172,27206,10533,5988,,0.615910532,0.238454224,0.135560989,,,
St. Charles Parish,Louisiana,22,089,22089,51863,25830,26033,51863,33706,11881,4134,,0.649904556,0.229084318,0.079710005,,,
St. Helena Parish,Louisiana,22,091,22091,10849,5265,5584,10849,5047,5442,245,,0.465204166,0.501613052,0.022582727,,,
St. James Parish,Louisiana,22,093,22093,19797,9536,10261,19797,9834,9572,372,,0.496741931,0.483507602,0.018790726,,,
St. John the Baptist Parish,Louisiana,22,095,22095,41342,20420,20922,41342,13358,23233,3449,,0.323109671,0.561970877,0.083426056,,,
St. Landry Parish,Louisiana,22,097,22097,82128,39828,42300,82128,43885,33110,2338,,0.534348821,0.403151179,0.028467758,,,
St. Martin Parish,Louisiana,22,099,22099,51559,25291,26268,51559,33427,14732,1746,,0.64832522,0.28573091,0.033864117,,,
St. Mary Parish,Louisiana,22,101,22101,48455,23727,24728,48455,27189,14084,4536,,0.561118564,0.290661438,0.09361263,,,
St. Tammany Parish,Louisiana,22,103,22103,269331,131916,137415,269331,201888,32914,21369,,0.749590652,0.122206504,0.079341034,,,
Tangipahoa Parish,Louisiana,22,105,22105,135218,65933,69285,135218,83835,40430,7511,,0.619998817,0.298998654,0.055547338,,,
Tensas Parish,Louisiana,22,107,22107,3992,1925,2067,3992,1660,2128,110,,0.415831663,0.533066132,0.02755511,,,
Terrebonne Parish,Louisiana,22,109,22109,107362,53160,54202,107362,70200,20674,7369,,0.653862633,0.192563477,0.068636948,,,
Union Parish,Louisiana,22,111,22111,20914,10140,10774,20914,14570,5194,1172,,0.696662523,0.248350387,0.056039017,,,
Vermilion Parish,Louisiana,22,113,22113,57031,27576,29455,57031,44728,7409,2378,,0.784275219,0.129911802,0.041696621,,,
Vernon Parish,Louisiana,22,115,22115,47764,24851,22913,47764,35560,6265,4379,,0.744493761,0.131165732,0.091679926,,,
Washington Parish,Louisiana,22,117,22117,45238,22648,22590,45238,29504,13418,1425,,0.652195057,0.296609045,0.031500066,,,
Webster Parish,Louisiana,22,119,22119,36189,17778,18411,36189,22752,12104,780,,0.628699329,0.334466274,0.021553511,,,
West Baton Rouge Parish,Louisiana,22,121,22121,27666,13685,13981,27666,15013,11215,1235,,0.54265163,0.405371214,0.04463963,,,
West Carroll Parish,Louisiana,22,123,22123,9622,4770,4852,9622,7752,1482,349,,0.80565371,0.154022033,0.036271046,,,
West Feliciana Parish,Louisiana,22,125,22125,15381,10459,4922,15381,7762,7021,222,,0.504648592,0.456472271,0.014433392,,,
Winn Parish,Louisiana,22,127,22127,13506,7339,6167,13506,8607,3884,979,,0.637272323,0.287575892,0.072486302,,,
Androscoggin County,Maine,23,001,23001,112323,55280,57043,112323,99648,5247,2373,,0.887155792,0.046713496,0.021126572,,,
Aroostook County,Maine,23,003,23003,67227,33618,33609,67227,62766,512,1059,,0.933642733,0.007615988,0.015752599,,,
Cumberland County,Maine,23,005,23005,305940,149007,156933,305940,267862,10209,8305,,0.875537687,0.033369288,0.027145846,,,
Franklin County,Maine,23,007,23007,30145,14810,15335,30145,28455,184,471,,0.943937635,0.006103831,0.015624482,,,
Hancock County,Maine,23,009,23009,56084,27447,28637,56084,52672,484,1004,,0.939162685,0.008629912,0.017901719,,,
Kennebec County,Maine,23,011,23011,125614,61478,64136,125614,117378,1021,2708,,0.93443406,0.008128075,0.021558107,,,
Knox County,Maine,23,013,23013,40860,20547,20313,40860,38677,152,734,,0.946573666,0.00372002,0.017963779,,,
Lincoln County,Maine,23,015,23015,35840,17656,18184,35840,33703,175,467,,0.940373884,0.004882813,0.013030134,,,
Oxford County,Maine,23,017,23017,58728,29254,29474,58728,55025,178,946,,0.936946601,0.003030922,0.01610816,,,
Penobscot County,Maine,23,019,23019,153571,76321,77250,153571,141450,1563,2967,,0.921072338,0.010177703,0.019320054,,,
Piscataquis County,Maine,23,021,23021,17125,8687,8438,17125,16002,130,305,,0.934423358,0.007591241,0.017810219,,,
Sagadahoc County,Maine,23,023,23023,37093,18181,18912,37093,34670,201,733,,0.934677702,0.005418812,0.019761141,,,
Somerset County,Maine,23,025,23025,50852,25300,25552,50852,48344,241,737,,0.950680406,0.004739243,0.014493039,,,
Waldo County,Maine,23,027,23027,40006,19834,20172,40006,37554,232,609,,0.938709194,0.00579913,0.015222717,,,
Washington County,Maine,23,029,23029,31261,15403,15858,31261,27657,311,734,,0.884712581,0.009948498,0.023479735,,,
York County,Maine,23,031,23031,214731,105540,109191,214731,196259,2305,4457,,0.913976091,0.010734361,0.020756202,,,
Allegany County,Maryland,24,001,24001,67762,35357,32405,67762,59149,4835,1260,,0.872893362,0.071352676,0.018594492,,,
Anne Arundel County,Maryland,24,003,24003,590936,292506,298430,590936,384920,104594,59213,,0.651373414,0.176997171,0.100202052,,,
Baltimore County,Maryland,24,005,24005,849586,404133,445453,849586,459349,257555,63048,,0.540673928,0.303153536,0.074210262,,,
Calvert County,Maryland,24,009,24009,93791,46707,47084,93791,71706,11461,4620,,0.764529646,0.122197226,0.049258458,,,
Caroline County,Maryland,24,011,24011,33406,16442,16964,33406,24762,4623,2930,,0.741244088,0.138388313,0.087708795,,,
Carroll County,Maryland,24,013,24013,174318,86706,87612,174318,152005,6936,8333,,0.871998302,0.03978935,0.04780344,,,
Cecil County,Maryland,24,015,24015,104366,51768,52598,104366,86756,7374,5617,,0.831266888,0.070655194,0.05382021,,,
Charles County,Maryland,24,017,24017,168710,81225,87485,168710,59708,83046,12648,,0.353909075,0.492241124,0.074968882,,,
Dorchester County,Maryland,24,019,24019,32612,15199,17413,32612,20172,8263,1909,,0.618545321,0.253372992,0.058536735,,,
Frederick County,Maryland,24,021,24021,280341,138716,141625,280341,197085,28924,34570,,0.703018824,0.103174348,0.123314107,,,
Garrett County,Maryland,24,023,24023,28713,14483,14230,28713,27412,217,377,,0.954689513,0.007557552,0.013129941,,,
Harford County,Maryland,24,025,24025,262509,129107,133402,262509,194602,38171,14585,,0.741315536,0.145408348,0.05556,,,
Howard County,Maryland,24,027,24027,333916,164614,169302,333916,163325,66663,28121,,0.489120018,0.199640029,0.084215791,,,
Kent County,Maryland,24,029,24029,19265,9301,9964,19265,14978,2739,1074,,0.7774721,0.142174929,0.055748767,,,
Montgomery County,Maryland,24,031,24031,1057586,515257,542329,1057586,469359,196862,218219,,0.443802206,0.186142782,0.206336884,,,
Prince George's County,Maryland,24,033,24033,955584,462493,493091,955584,125734,571024,207694,,0.131578176,0.597565468,0.217347716,,,
Queen Anne's County,Maryland,24,035,24035,50951,25350,25601,50951,42963,3041,2678,,0.843221919,0.059684795,0.052560303,,,
St. Mary's County,Maryland,24,037,24037,114372,57683,56689,114372,82702,16874,6805,,0.723096562,0.14753611,0.059498828,,,
Somerset County,Maryland,24,039,24039,24685,13492,11193,24685,12897,9750,1099,,0.522463034,0.394976707,0.044520964,,,
Talbot County,Maryland,24,041,24041,37707,18115,19592,37707,28535,4521,3432,,0.75675604,0.119898162,0.091017583,,,
Washington County,Maryland,24,043,24043,155033,78714,76319,155033,119045,17807,11320,,0.767868776,0.114859417,0.073016713,,,
Wicomico County,Maryland,24,045,24045,104117,49797,54320,104117,63048,27563,7210,,0.605549526,0.264731024,0.069249018,,,
Worcester County,Maryland,24,047,24047,53279,25982,27297,53279,42356,6502,2090,,0.794984891,0.122036825,0.039227463,,,
Baltimore city,Maryland,24,510,24510,577193,268932,308261,577193,158163,346535,45420,,0.274020995,0.600379769,0.078691183,,,
Barnstable County,Massachusetts,25,001,25001,230073,110864,119209,230073,200101,6298,8178,,0.869728304,0.02737392,0.03554524,,,
Berkshire County,Massachusetts,25,003,25003,128047,62835,65212,128047,111769,3218,7176,,0.872874804,0.025131397,0.056041922,,,
Bristol County,Massachusetts,25,005,25005,578436,282434,296002,578436,454457,25495,56800,,0.785665138,0.044075749,0.098195825,,,
Dukes County,Massachusetts,25,007,25007,20751,10229,10522,20751,16958,691,641,,0.817213628,0.0332996,0.030890078,,,
Essex County,Massachusetts,25,009,25009,807258,392167,415091,807258,567305,33498,187521,,0.702755501,0.041496027,0.232293765,,,
Franklin County,Massachusetts,25,011,25011,70922,34998,35924,70922,63431,1002,3691,,0.894376921,0.014128197,0.05204309,,,
Hampden County,Massachusetts,25,013,25013,462853,225006,237847,462853,312186,40286,123001,,0.674481963,0.087038433,0.26574528,,,
Hampshire County,Massachusetts,25,015,25015,156595,73249,83346,156595,130409,3647,11259,,0.832778824,0.023289377,0.071898847,,,
Middlesex County,Massachusetts,25,017,25017,1622896,800913,821983,1622896,1119143,81701,145868,,0.689596253,0.050342721,0.089881299,,,
Nantucket County,Massachusetts,25,019,25019,14299,7267,7032,14299,10125,1333,2347,,0.708091475,0.093223302,0.164137352,,,
Norfolk County,Massachusetts,25,021,25021,724540,351264,373276,724540,517445,52468,40130,,0.71417037,0.072415602,0.055386866,,,
Plymouth County,Massachusetts,25,023,25023,531889,260181,271708,531889,414831,46620,25022,,0.779920247,0.087649867,0.04704365,,,
Suffolk County,Massachusetts,25,025,25025,782172,377757,404415,782172,376551,149342,178286,,0.481417131,0.190932429,0.227937078,,,
Worcester County,Massachusetts,25,027,25027,861664,427601,434063,861664,650963,43791,114759,,0.755471971,0.050821434,0.133183004,,,
Alcona County,Michigan,26,001,26001,10310,5187,5123,10310,9727,28,157,,0.943452958,0.00271581,0.015227934,,,
Alger County,Michigan,26,003,26003,8813,4997,3816,8813,7234,694,147,,0.820832861,0.078747305,0.016679905,,,
Allegan County,Michigan,26,005,26005,120913,60740,60173,120913,107957,1480,9674,,0.892848577,0.012240206,0.08000794,,,
Alpena County,Michigan,26,007,26007,28908,14430,14478,28908,26978,249,458,,0.933236474,0.008613533,0.015843365,,,
Antrim County,Michigan,26,009,26009,23876,11958,11918,23876,22409,85,507,,0.938557547,0.00356006,0.021234713,,,
Arenac County,Michigan,26,011,26011,15054,7711,7343,15054,14135,91,321,,0.938953102,0.006044905,0.021323236,,,
Baraga County,Michigan,26,013,26013,8249,4561,3688,8249,5991,557,140,,0.726269851,0.067523336,0.016971754,,,
Barry County,Michigan,26,015,26015,62982,31811,31171,62982,58969,304,2264,,0.936283383,0.004826776,0.035946778,,,
Bay County,Michigan,26,017,26017,103235,51143,52092,103235,94827,1405,6023,,0.918554754,0.013609725,0.058342616,,,
Benzie County,Michigan,26,019,26019,18177,9130,9047,18177,16736,88,440,,0.920723992,0.004841283,0.024206415,,,
Berrien County,Michigan,26,021,26021,153411,75454,77957,153411,115071,20727,9396,,0.75008311,0.135107652,0.061247238,,,
Branch County,Michigan,26,023,26023,44914,23294,21620,44914,40123,865,2811,,0.893329474,0.019259028,0.062586276,,,
Calhoun County,Michigan,26,025,26025,133846,66007,67839,133846,103642,13464,7678,,0.774337672,0.100593219,0.057364434,,,
Cass County,Michigan,26,027,26027,51606,25989,25617,51606,44422,2233,2240,,0.860791381,0.043270162,0.043405806,,,
Charlevoix County,Michigan,26,029,26029,26143,13095,13048,26143,24483,137,503,,0.936503079,0.005240409,0.019240332,,,
Cheboygan County,Michigan,26,031,26031,25778,12999,12779,25778,23269,226,417,,0.902668943,0.008767166,0.016176585,,,
Chippewa County,Michigan,26,033,26033,36448,19831,16617,36448,24783,2106,802,,0.679955004,0.057780948,0.022003951,,,
Clare County,Michigan,26,035,26035,31109,15674,15435,31109,29356,190,684,,0.943649748,0.006107557,0.021987206,,,
Clinton County,Michigan,26,037,26037,79419,39389,40030,79419,71199,1315,4042,,0.896498319,0.016557751,0.050894622,,,
Crawford County,Michigan,26,039,26039,13271,6793,6478,13271,12375,40,311,,0.932484364,0.003014091,0.023434557,,,
Delta County,Michigan,26,041,26041,36829,18564,18265,36829,33411,96,552,,0.907192701,0.002606642,0.014988189,,,
Dickinson County,Michigan,26,043,26043,25940,13166,12774,25940,24211,216,475,,0.933346184,0.008326908,0.018311488,,,
Eaton County,Michigan,26,045,26045,109000,53937,55063,109000,89972,7631,6718,,0.825431193,0.070009174,0.061633028,,,
Emmet County,Michigan,26,047,26047,34159,17000,17159,34159,30871,228,683,,0.903744255,0.006674668,0.019994731,,,
Genesee County,Michigan,26,049,26049,404087,195812,208275,404087,293482,78330,16683,,0.726284191,0.193844395,0.041285664,,,
Gladwin County,Michigan,26,051,26051,25543,12943,12600,25543,24106,65,543,,0.943741925,0.002544728,0.02125827,,,
Gogebic County,Michigan,26,053,26053,14348,7403,6945,14348,13196,125,270,,0.919710064,0.008712016,0.018817954,,,
Grand Traverse County,Michigan,26,055,26055,95757,47306,48451,95757,88560,845,3138,,0.924841004,0.00882442,0.03277045,,,
Gratiot County,Michigan,26,057,26057,41478,22435,19043,41478,36259,2268,3134,,0.874174261,0.054679589,0.075558127,,,
Hillsdale County,Michigan,26,059,26059,45658,22930,22728,45658,43116,333,1249,,0.9443252,0.007293355,0.027355557,,,
Houghton County,Michigan,26,061,26061,37428,20501,16927,37428,34345,423,676,,0.917628513,0.011301699,0.018061344,,,
Huron County,Michigan,26,063,26063,31258,15615,15643,31258,29474,126,855,,0.942926611,0.004030968,0.027352998,,,
Ingham County,Michigan,26,065,26065,282015,137993,144022,282015,198496,33264,24396,,0.703849086,0.117951173,0.086506037,,,
Ionia County,Michigan,26,067,26067,66706,36246,30460,66706,58444,2537,3466,,0.876143076,0.038032561,0.051959344,,,
Iosco County,Michigan,26,069,26069,25333,12625,12708,25333,23416,224,688,,0.924327952,0.008842222,0.027158252,,,
Iron County,Michigan,26,071,26071,11650,5823,5827,11650,10874,98,245,,0.933390558,0.008412017,0.021030043,,,
Isabella County,Michigan,26,073,26073,64475,31475,33000,64475,55025,1812,3144,,0.853431563,0.028103916,0.048763086,,,
Jackson County,Michigan,26,075,26075,160187,82287,77900,160187,134365,12267,6352,,0.838800901,0.076579248,0.039653655,,,
Kalamazoo County,Michigan,26,077,26077,261437,128302,133135,261437,200753,28836,15121,,0.767882893,0.110298083,0.057838026,,,
Kalkaska County,Michigan,26,079,26079,18116,9218,8898,18116,16988,160,402,,0.937734599,0.008831972,0.022190329,,,
Kent County,Michigan,26,081,26081,658844,327144,331700,658844,486762,62581,75849,,0.738812223,0.094986067,0.115124369,,,
Keweenaw County,Michigan,26,083,26083,2106,1072,1034,2106,2021,0,32,,0.959639126,0,0.015194682,,,
Lake County,Michigan,26,085,26085,12393,6725,5668,12393,9930,1077,1146,,0.801258775,0.086903897,0.092471557,,,
Lapeer County,Michigan,26,087,26087,88703,45610,43093,88703,81293,1043,4394,,0.916462803,0.01175834,0.049536092,,,
Leelanau County,Michigan,26,089,26089,22607,11218,11389,22607,20448,85,964,,0.904498607,0.003759897,0.04264166,,,
Lenawee County,Michigan,26,091,26091,98823,50126,48697,98823,87997,2229,8650,,0.890450604,0.022555478,0.087530231,,,
Livingston County,Michigan,26,093,26093,195143,98498,96645,195143,183582,1005,5615,,0.940756266,0.005150069,0.028773771,,,
Luce County,Michigan,26,095,26095,6325,3783,2542,6325,4909,519,115,,0.776126482,0.082055336,0.018181818,,,
Mackinac County,Michigan,26,097,26097,10865,5528,5337,10865,7827,454,224,,0.720386562,0.04178555,0.020616659,,,
Macomb County,Michigan,26,099,26099,877624,429803,447821,877624,668634,109372,27006,,0.761868408,0.124622845,0.03077172,,,
Manistee County,Michigan,26,101,26101,25247,13005,12242,25247,22541,869,882,,0.892818949,0.034419931,0.034934844,,,
Marquette County,Michigan,26,103,26103,66430,33695,32735,66430,60774,977,1345,,0.914857745,0.014707211,0.020246876,,,
Mason County,Michigan,26,105,26105,29177,14665,14512,29177,26934,319,1389,,0.923124379,0.010933269,0.047605991,,,
Mecosta County,Michigan,26,107,26107,40321,20108,20213,40321,36668,925,1125,,0.909402049,0.022940899,0.027901094,,,
Menominee County,Michigan,26,109,26109,23295,12025,11270,23295,21520,130,534,,0.923803391,0.005580597,0.022923374,,,
Midland County,Michigan,26,111,26111,83641,41782,41859,83641,75970,1180,2784,,0.908286606,0.014107914,0.033285111,,,
Missaukee County,Michigan,26,113,26113,15156,7701,7455,15156,14017,73,501,,0.924848245,0.004816574,0.033056215,,,
Monroe County,Michigan,26,115,26115,155001,77322,77679,155001,140956,3463,6559,,0.909387681,0.022341791,0.042315856,,,
Montcalm County,Michigan,26,117,26117,67174,35985,31189,67174,59806,2172,2826,,0.890314705,0.032333939,0.042069848,,,
Montmorency County,Michigan,26,119,26119,9372,4823,4549,9372,8802,15,153,,0.939180538,0.001600512,0.016325224,,,
Muskegon County,Michigan,26,121,26121,175378,87488,87890,175378,135466,22109,10671,,0.772422995,0.126064843,0.060845716,,,
Newaygo County,Michigan,26,123,26123,50414,25544,24870,50414,45316,371,3079,,0.898877296,0.007359067,0.061074305,,,
Oakland County,Michigan,26,125,26125,1272294,628221,644073,1272294,897702,165635,62197,,0.705577484,0.130186105,0.048885714,,,
Oceana County,Michigan,26,127,26127,26788,13683,13105,26788,23684,248,4135,,0.884127221,0.009257877,0.154360161,,,
Ogemaw County,Michigan,26,129,26129,20853,10508,10345,20853,19611,135,461,,0.940440224,0.006473889,0.022107131,,,
Ontonagon County,Michigan,26,131,26131,5870,2992,2878,5870,5487,49,100,,0.934752981,0.00834753,0.017035775,,,
Osceola County,Michigan,26,133,26133,23122,11803,11319,23122,21537,251,463,,0.931450567,0.010855462,0.020024219,,,
Oscoda County,Michigan,26,135,26135,8338,4270,4068,8338,7856,32,170,,0.942192372,0.003837851,0.020388582,,,
Otsego County,Michigan,26,137,26137,25352,12868,12484,25352,23760,239,490,,0.937204165,0.009427264,0.019327864,,,
Ottawa County,Michigan,26,139,26139,298614,148156,150458,298614,255201,4673,30177,,0.854618337,0.015648965,0.101056883,,,
Presque Isle County,Michigan,26,141,26141,13142,6578,6564,13142,12575,41,198,,0.956855882,0.003119769,0.0150662,,,
Roscommon County,Michigan,26,143,26143,23639,11919,11720,23639,22144,145,471,,0.936757054,0.006133931,0.019924701,,,
Saginaw County,Michigan,26,145,26145,189210,92309,96901,189210,135723,35809,17188,,0.717314095,0.189255325,0.090840865,,,
St. Clair County,Michigan,26,147,26147,160089,79999,80090,160089,146571,3713,5753,,0.91555947,0.023193349,0.03593626,,,
St. Joseph County,Michigan,26,149,26149,60870,30677,30193,60870,53093,1345,5553,,0.872235913,0.022096271,0.091227206,,,
Sanilac County,Michigan,26,151,26151,40574,20463,20111,40574,38046,165,1697,,0.93769409,0.004066644,0.041824814,,,
Schoolcraft County,Michigan,26,153,26153,8093,4042,4051,8093,6820,52,123,,0.842703571,0.006425306,0.01519832,,,
Shiawassee County,Michigan,26,155,26155,68061,33855,34206,68061,64514,406,2071,,0.947884986,0.005965237,0.030428586,,,
Tuscola County,Michigan,26,157,26157,53071,26977,26094,53071,49654,608,1923,,0.935614554,0.011456351,0.036234478,,,
Van Buren County,Michigan,26,159,26159,75681,37702,37979,75681,62002,2625,9248,,0.819254502,0.03468506,0.122197117,,,
Washtenaw County,Michigan,26,161,26161,368394,183761,184633,368394,257686,42757,20789,,0.699484791,0.116063237,0.056431429,,,
Wayne County,Michigan,26,163,26163,1773767,858831,914936,1773767,886114,660271,119108,,0.499566178,0.372242239,0.067149744,,,
Wexford County,Michigan,26,165,26165,33868,17041,16827,33868,31309,354,845,,0.924441951,0.010452344,0.024949805,,,
Aitkin County,Minnesota,27,001,27001,15930,8036,7894,15930,14887,113,233,,0.934526051,0.007093534,0.014626491,,,
Anoka County,Minnesota,27,003,27003,367095,184597,182498,367095,283489,30611,20537,,0.77224969,0.083387134,0.055944646,,,
Becker County,Minnesota,27,005,27005,35260,17667,17593,35260,30380,293,665,,0.861599546,0.008309699,0.018859898,,,
Beltrami County,Minnesota,27,007,27007,46421,23392,23029,46421,32925,636,1170,,0.709269512,0.013700696,0.02520411,,,
Benton County,Minnesota,27,009,27009,41458,20690,20768,41458,36188,1620,1346,,0.8728834,0.039075691,0.032466593,,,
Big Stone County,Minnesota,27,011,27011,5152,2612,2540,5152,4889,9,130,,0.948951863,0.001746894,0.025232919,,,
Blue Earth County,Minnesota,27,013,27013,69386,35092,34294,69386,60199,3177,3252,,0.867595769,0.045787335,0.046868244,,,
Brown County,Minnesota,27,015,27015,25826,12928,12898,25826,24319,219,1252,,0.941647952,0.008479827,0.048478278,,,
Carlton County,Minnesota,27,017,27017,36457,19307,17150,36457,32077,763,676,,0.879858463,0.020928765,0.018542392,,,
Carver County,Minnesota,27,019,27019,108622,54415,54207,108622,95421,1665,5393,,0.87846845,0.015328387,0.049649242,,,
Cass County,Minnesota,27,021,27021,30688,15808,14880,30688,25087,123,530,,0.817485662,0.004008081,0.017270594,,,
Chippewa County,Minnesota,27,023,27023,12388,6160,6228,12388,10553,113,1228,,0.85187278,0.009121731,0.099128189,,,
Chisago County,Minnesota,27,025,27025,57434,29865,27569,57434,52665,688,1565,,0.91696556,0.011978967,0.027248668,,,
Clay County,Minnesota,27,027,27027,65628,32675,32953,65628,56650,3174,3186,,0.863198635,0.048363503,0.048546352,,,
Clearwater County,Minnesota,27,029,27029,8579,4365,4214,8579,7253,14,75,,0.845436531,0.001631892,0.008742278,,,
Cook County,Minnesota,27,031,27031,5633,2794,2839,5633,4792,26,156,,0.850701225,0.004615658,0.027693946,,,
Cottonwood County,Minnesota,27,033,27033,11458,5728,5730,11458,9483,201,1203,,0.827631349,0.017542329,0.104992145,,,
Crow Wing County,Minnesota,27,035,27035,67113,33485,33628,67113,63196,393,1024,,0.941635749,0.005855795,0.015257849,,,
Dakota County,Minnesota,27,037,27037,442204,219493,222711,442204,335999,32429,37321,,0.759828043,0.073334931,0.084397699,,,
Dodge County,Minnesota,27,039,27039,20962,10654,10308,20962,19131,206,1084,,0.912651465,0.009827307,0.051712623,,,
Douglas County,Minnesota,27,041,27041,39354,19853,19501,39354,37462,186,848,,0.951923566,0.00472633,0.021548,,,
Faribault County,Minnesota,27,043,27043,13909,7054,6855,13909,12486,83,1086,,0.897692142,0.005967359,0.078078942,,,
Fillmore County,Minnesota,27,045,27045,21346,10812,10534,21346,20343,134,395,,0.953012274,0.006277523,0.018504638,,,
Freeborn County,Minnesota,27,047,27047,30752,15502,15250,30752,26115,387,3249,,0.849213059,0.012584547,0.105651665,,,
Goodhue County,Minnesota,27,049,27049,47844,23985,23859,47844,43204,785,1879,,0.903018142,0.016407491,0.039273472,,,
Grant County,Minnesota,27,051,27051,6108,3122,2986,6108,5749,31,158,,0.941224623,0.005075311,0.025867714,,,
Hennepin County,Minnesota,27,053,27053,1268903,631257,637646,1268903,857471,168909,97813,,0.675757721,0.133114194,0.077084694,,,
Houston County,Minnesota,27,055,27055,18768,9441,9327,18768,17650,66,279,,0.94043052,0.003516624,0.014865729,,,
Hubbard County,Minnesota,27,057,27057,21700,11040,10660,21700,19758,107,553,,0.910506912,0.004930876,0.025483871,,,
Isanti County,Minnesota,27,059,27059,41934,21218,20716,41934,38796,435,1009,,0.925168121,0.010373444,0.024061621,,,
Itasca County,Minnesota,27,061,27061,45141,22858,22283,45141,40338,305,656,,0.893600053,0.006756607,0.014532243,,,
Jackson County,Minnesota,27,063,27063,9964,5101,4863,9964,9167,62,450,,0.920012043,0.006222401,0.045162585,,,
Kanabec County,Minnesota,27,065,27065,16261,8169,8092,16261,15363,83,282,,0.944775844,0.005104237,0.017342107,,,
Kandiyohi County,Minnesota,27,067,27067,43757,22134,21623,43757,35471,2465,6109,,0.810636013,0.056333844,0.139611948,,,
Kittson County,Minnesota,27,069,27069,4163,2065,2098,4163,3905,26,104,,0.938025462,0.006245496,0.024981984,,,
Koochiching County,Minnesota,27,071,27071,11950,6084,5866,11950,10783,67,175,,0.902343096,0.005606695,0.014644351,,,
Lac qui Parle County,Minnesota,27,073,27073,6694,3434,3260,6694,6288,42,210,,0.93934867,0.006274275,0.031371377,,,
Lake County,Minnesota,27,075,27075,10911,5672,5239,10911,10422,43,154,,0.955182843,0.003940977,0.014114197,,,
Lake of the Woods County,Minnesota,27,077,27077,3800,2059,1741,3800,3447,10,26,,0.907105263,0.002631579,0.006842105,,,
Le Sueur County,Minnesota,27,079,27079,28936,14693,14243,28936,26515,255,1922,,0.916332596,0.008812552,0.06642245,,,
Lincoln County,Minnesota,27,081,27081,5594,2825,2769,5594,5342,9,131,,0.954951734,0.001608867,0.023417948,,,
Lyon County,Minnesota,27,083,27083,25498,12489,13009,25498,21279,634,1881,,0.834536042,0.024864695,0.073770492,,,
McLeod County,Minnesota,27,085,27085,36771,18480,18291,36771,33582,195,2664,,0.913274047,0.005303092,0.072448397,,,
Mahnomen County,Minnesota,27,087,27087,5371,2739,2632,5371,2434,11,198,,0.453174455,0.002048036,0.036864643,,,
Marshall County,Minnesota,27,089,27089,8961,4536,4425,8961,8352,31,415,,0.932038835,0.003459435,0.046311796,,,
Martin County,Minnesota,27,091,27091,19864,10025,9839,19864,18490,160,1352,,0.930829642,0.008054772,0.068062827,,,
Meeker County,Minnesota,27,093,27093,23422,12019,11403,23422,22105,37,1005,,0.943770814,0.001579711,0.042908377,,,
Mille Lacs County,Minnesota,27,095,27095,26912,13692,13220,26912,24031,83,582,,0.892947384,0.003084126,0.02162604,,,
Morrison County,Minnesota,27,097,27097,34131,17404,16727,34131,32526,108,632,,0.952975301,0.003164279,0.018516891,,,
Mower County,Minnesota,27,099,27099,40069,20137,19932,40069,31608,1417,5226,,0.788839252,0.035363997,0.130425017,,,
Murray County,Minnesota,27,101,27101,8119,4074,4045,8119,7408,50,397,,0.912427639,0.006158394,0.048897647,,,
Nicollet County,Minnesota,27,103,27103,34350,17299,17051,34350,30057,1193,1825,,0.875021834,0.034730713,0.053129549,,,
Nobles County,Minnesota,27,105,27105,22067,11390,10677,22067,13465,1149,7314,,0.610187157,0.0520687,0.331445144,,,
Norman County,Minnesota,27,107,27107,6411,3300,3111,6411,5756,69,334,,0.897831852,0.010762752,0.052097957,,,
Olmsted County,Minnesota,27,109,27109,163425,80065,83360,163425,128587,11818,9448,,0.786825761,0.072314517,0.057812452,,,
Otter Tail County,Minnesota,27,111,27111,60281,30463,29818,60281,55320,608,2260,,0.917702095,0.010086097,0.037491083,,,
Pennington County,Minnesota,27,113,27113,13877,6944,6933,13877,12634,161,663,,0.910427326,0.011601931,0.047776897,,,
Pine County,Minnesota,27,115,27115,29411,15769,13642,29411,26349,690,786,,0.895889293,0.02346061,0.026724695,,,
Pipestone County,Minnesota,27,117,27117,9352,4635,4717,9352,8142,181,789,,0.870615911,0.019354149,0.08436698,,,
Polk County,Minnesota,27,119,27119,30905,15777,15128,30905,26877,677,2074,,0.869665103,0.02190584,0.067108882,,,
Pope County,Minnesota,27,121,27121,11363,5835,5528,11363,10750,71,223,,0.946052979,0.00624835,0.019625099,,,
Ramsey County,Minnesota,27,123,27123,544438,267286,277152,544438,330661,66223,44888,,0.60734372,0.121635521,0.082448323,,,
Red Lake County,Minnesota,27,125,27125,3922,2030,1892,3922,3629,24,133,,0.925293218,0.006119327,0.03391127,,,
Redwood County,Minnesota,27,127,27127,15383,7685,7698,15383,13285,87,613,,0.86361568,0.005655594,0.039849184,,,
Renville County,Minnesota,27,129,27129,14587,7417,7170,14587,12767,124,1414,,0.87523137,0.00850072,0.096935628,,,
Rice County,Minnesota,27,131,27131,67389,34585,32804,67389,54125,4350,6885,,0.803172625,0.064550594,0.10216801,,,
Rock County,Minnesota,27,133,27133,9628,4714,4914,9628,9065,17,362,,0.94152472,0.001765683,0.037598671,,,
Roseau County,Minnesota,27,135,27135,15301,8008,7293,15301,13700,159,268,,0.895366316,0.010391478,0.017515195,,,
St. Louis County,Minnesota,27,137,27137,200056,100725,99331,200056,181117,3199,3767,,0.905331507,0.015990523,0.018829728,,,
Scott County,Minnesota,27,139,27139,152957,76534,76423,152957,120185,8017,9435,,0.785743706,0.052413423,0.061684003,,,
Sherburne County,Minnesota,27,141,27141,99178,50781,48397,99178,87092,3630,3167,,0.878138297,0.036600859,0.031932485,,,
Sibley County,Minnesota,27,143,27143,14933,7688,7245,14933,13357,147,1351,,0.89446193,0.00984397,0.090470769,,,
Stearns County,Minnesota,27,145,27145,159358,80599,78759,159358,132088,13425,7190,,0.828875864,0.08424428,0.045118538,,,
Steele County,Minnesota,27,147,27147,37413,18866,18547,37413,32527,1309,3231,,0.869403683,0.034987838,0.086360356,,,
Stevens County,Minnesota,27,149,27149,9686,5124,4562,9686,8051,170,1039,,0.83119967,0.017551105,0.107268222,,,
Swift County,Minnesota,27,151,27151,9787,5071,4716,9787,8812,68,671,,0.900378053,0.006947992,0.068560335,,,
Todd County,Minnesota,27,153,27153,25402,13086,12316,25402,22333,176,2335,,0.879182742,0.006928588,0.091921896,,,
Traverse County,Minnesota,27,155,27155,3279,1628,1651,3279,2852,16,184,,0.869777371,0.004879536,0.056114669,,,
Wabasha County,Minnesota,27,157,27157,21519,10885,10634,21519,20523,80,712,,0.953715321,0.003717645,0.033087039,,,
Wadena County,Minnesota,27,159,27159,14135,7055,7080,14135,12904,102,324,,0.912911213,0.00721613,0.022921825,,,
Waseca County,Minnesota,27,161,27161,18958,9082,9876,18958,16963,206,1322,,0.894767381,0.010866125,0.069733094,,,
Washington County,Minnesota,27,163,27163,272298,135528,136770,272298,217018,13314,13798,,0.796987124,0.048894961,0.050672425,,,
Watonwan County,Minnesota,27,165,27165,11169,5645,5524,11169,8808,1,3253,,0.788611335,8.95335E-05,0.291252574,,,
Wilkin County,Minnesota,27,167,27167,6413,3398,3015,6413,5938,14,238,,0.925931701,0.002183066,0.037112116,,,
Winona County,Minnesota,27,169,27169,49705,24698,25007,49705,45156,847,1876,,0.908480032,0.017040539,0.037742682,,,
Wright County,Minnesota,27,171,27171,145270,73993,71277,145270,129900,2707,5077,,0.894197012,0.018634267,0.034948716,,,
Yellow Medicine County,Minnesota,27,173,27173,9509,4810,4699,9509,8444,71,493,,0.888000841,0.007466611,0.05184562,,,
Adams County,Mississippi,28,001,28001,29098,14062,15036,29098,11167,16141,1191,,0.383772081,0.554711664,0.040930648,,,
Alcorn County,Mississippi,28,003,28003,34500,16878,17622,34500,27926,3765,1273,,0.809449275,0.109130435,0.036898551,,,
Amite County,Mississippi,28,005,28005,12611,5981,6630,12611,7352,5053,8,,0.58298311,0.400681944,0.000634367,,,
Attala County,Mississippi,28,007,28007,17685,8408,9277,17685,9242,8028,87,,0.522589765,0.45394402,0.004919423,,,
Benton County,Mississippi,28,009,28009,7592,3759,3833,7592,4614,2600,169,,0.607744995,0.342465753,0.022260274,,,
Bolivar County,Mississippi,28,011,28011,30163,14167,15996,30163,9251,19074,765,,0.306700262,0.632364155,0.025362199,,,
Calhoun County,Mississippi,28,013,28013,13029,6495,6534,13029,8376,3744,773,,0.64287359,0.287358968,0.059329189,,,
Carroll County,Mississippi,28,015,28015,9828,5194,4634,9828,6208,3394,24,,0.631664632,0.345339845,0.002442002,,,
Chickasaw County,Mississippi,28,017,28017,16994,8337,8657,16994,8540,7568,688,,0.502530305,0.445333647,0.040484877,,,
Choctaw County,Mississippi,28,019,28019,8172,4001,4171,8172,5524,2395,144,,0.675966716,0.293073911,0.017621145,,,
Claiborne County,Mississippi,28,021,28021,8908,4271,4637,8908,968,7681,20,,0.108666367,0.862258644,0.002245173,,,
Clarke County,Mississippi,28,023,28023,15424,7300,8124,15424,9759,5300,155,,0.632715249,0.343620332,0.010049274,,,
Clay County,Mississippi,28,025,28025,18462,8646,9816,18462,6998,11095,31,,0.379048857,0.600964143,0.001679125,,,
Coahoma County,Mississippi,28,027,28027,20808,9688,11120,20808,4048,15784,444,,0.194540561,0.758554402,0.021337947,,,
Copiah County,Mississippi,28,029,28029,27994,13364,14630,27994,12090,14196,1150,,0.43187826,0.507108666,0.041080231,,,
Covington County,Mississippi,28,031,28031,18226,9161,9065,18226,11002,6313,465,,0.603643147,0.346373313,0.025513003,,,
DeSoto County,Mississippi,28,033,28033,188598,91046,97552,188598,112258,60277,10612,,0.595223703,0.319605722,0.056267829,,,
Forrest County,Mississippi,28,035,28035,78027,36467,41560,78027,44647,27898,3264,,0.572199367,0.357542902,0.041831674,,,
Franklin County,Mississippi,28,037,28037,7655,3895,3760,7655,4789,2678,70,,0.62560418,0.349836708,0.00914435,,,
George County,Mississippi,28,039,28039,24870,12518,12352,24870,21491,1933,747,,0.864133494,0.077724166,0.030036188,,,
Greene County,Mississippi,28,041,28041,13595,8241,5354,13595,9745,3375,181,,0.71680765,0.248253034,0.013313718,,,
Grenada County,Mississippi,28,043,28043,21342,10255,11087,21342,10902,9559,64,,0.510823728,0.447896167,0.002998782,,,
Hancock County,Mississippi,28,045,28045,46057,22470,23587,46057,38869,3119,1924,,0.843932518,0.067720433,0.041774323,,,
Harrison County,Mississippi,28,047,28047,209443,102375,107068,209443,132198,50579,14023,,0.631188438,0.241492912,0.066953777,,,
Hinds County,Mississippi,28,049,28049,222494,104138,118356,222494,52494,161009,4500,,0.235934452,0.723655469,0.020225265,,,
Holmes County,Mississippi,28,051,28051,16491,7925,8566,16491,2349,13591,71,,0.142441332,0.824146504,0.004305379,,,
Humphreys County,Mississippi,28,053,28053,7570,3626,3944,7570,1538,5966,5,,0.20317041,0.788110964,0.000660502,,,
Issaquena County,Mississippi,28,055,28055,1095,731,364,1095,291,768,14,,0.265753425,0.701369863,0.012785388,,,
Itawamba County,Mississippi,28,057,28057,23942,11834,12108,23942,21451,1867,437,,0.895956896,0.077980119,0.018252443,,,
Jackson County,Mississippi,28,059,28059,144437,71179,73258,144437,98632,29659,10560,,0.682872117,0.205342121,0.07311146,,,
Jasper County,Mississippi,28,061,28061,16211,8031,8180,16211,7321,8630,99,,0.451606934,0.532354574,0.006106964,,,
Jefferson County,Mississippi,28,063,28063,7127,3447,3680,7127,942,5789,310,,0.132173425,0.812263224,0.043496562,,,
Jefferson Davis County,Mississippi,28,065,28065,11183,5269,5914,11183,4256,6729,19,,0.380577663,0.601716892,0.001699007,,,
Jones County,Mississippi,28,067,28067,66839,32663,34176,66839,43698,19200,4071,,0.653779979,0.28725744,0.060907554,,,
Kemper County,Mississippi,28,069,28069,8855,4486,4369,8855,2986,5352,64,,0.337210615,0.604404291,0.007227555,,,
Lafayette County,Mississippi,28,071,28071,56920,27251,29669,56920,39747,13173,2063,,0.698295854,0.231430077,0.036243851,,,
Lamar County,Mississippi,28,073,28073,65081,31149,33932,65081,47389,14048,2366,,0.728154146,0.21585409,0.036354696,,,
Lauderdale County,Mississippi,28,075,28075,71984,34795,37189,71984,37119,30200,1782,,0.515656257,0.419537675,0.024755501,,,
Lawrence County,Mississippi,28,077,28077,11883,5768,6115,11883,7641,3775,245,,0.64301944,0.31768072,0.020617689,,,
Leake County,Mississippi,28,079,28079,21288,10289,10999,21288,9942,8319,1260,,0.467023675,0.39078354,0.059188275,,,
Lee County,Mississippi,28,081,28081,83138,39738,43400,83138,52720,24885,2835,,0.634126392,0.29932161,0.03409993,,,
Leflore County,Mississippi,28,083,28083,27432,12842,14590,27432,5859,20432,837,,0.213582677,0.744823564,0.030511811,,,
Lincoln County,Mississippi,28,085,28085,34830,16711,18119,34830,23616,10542,443,,0.678036176,0.302670112,0.01271892,,,
Lowndes County,Mississippi,28,087,28087,58187,27929,30258,58187,29181,25585,1305,,0.501503772,0.439703026,0.02242769,,,
Madison County,Mississippi,28,089,28089,110303,53027,57276,110303,61170,41181,4131,,0.554563339,0.373344333,0.037451384,,,
Marion County,Mississippi,28,091,28091,24303,11633,12670,24303,15529,7802,431,,0.638974612,0.321030325,0.017734436,,,
Marshall County,Mississippi,28,093,28093,33899,16820,17079,33899,15989,14800,1632,,0.471665831,0.43659105,0.048143013,,,
Monroe County,Mississippi,28,095,28095,33928,16310,17618,33928,22819,10242,512,,0.672571328,0.301874558,0.01509078,,,
Montgomery County,Mississippi,28,097,28097,9708,4751,4957,9708,5080,4389,27,,0.523279769,0.45210136,0.002781211,,,
Neshoba County,Mississippi,28,099,28099,28927,13865,15062,28927,16708,6201,255,,0.577591869,0.2143672,0.008815294,,,
Newton County,Mississippi,28,101,28101,21151,10190,10961,21151,12465,6735,385,,0.589333838,0.318424661,0.018202449,,,
Noxubee County,Mississippi,28,103,28103,10136,4664,5472,10136,2574,7485,19,,0.25394633,0.738456985,0.001874507,,,
Oktibbeha County,Mississippi,28,105,28105,51473,25382,26091,51473,28713,18650,1220,,0.557826433,0.36232588,0.023701747,,,
Panola County,Mississippi,28,107,28107,32965,15762,17203,32965,15487,15845,673,,0.469801304,0.480661307,0.020415592,,,
Pearl River County,Mississippi,28,109,28109,56781,27857,28924,56781,45649,7003,2331,,0.803948504,0.123333509,0.041052465,,,
Perry County,Mississippi,28,111,28111,11459,5719,5740,11459,8890,1813,200,,0.775809407,0.158216249,0.01745353,,,
Pike County,Mississippi,28,113,28113,39930,18763,21167,39930,16769,21599,653,,0.41995993,0.540921613,0.016353619,,,
Pontotoc County,Mississippi,28,115,28115,31312,15401,15911,31312,23537,4626,2148,,0.751692642,0.147738886,0.068599898,,,
Prentiss County,Mississippi,28,117,28117,24999,12379,12620,24999,20036,2855,377,,0.801472059,0.114204568,0.015080603,,,
Quitman County,Mississippi,28,119,28119,5908,2778,3130,5908,1475,4267,26,,0.249661476,0.722241029,0.004400812,,,
Rankin County,Mississippi,28,121,28121,158218,76489,81729,158218,114094,34246,5072,,0.721118962,0.216448192,0.032057035,,,
Scott County,Mississippi,28,123,28123,27754,14032,13722,27754,13958,9291,4118,,0.502918498,0.334762557,0.148375009,,,
Sharkey County,Mississippi,28,125,28125,3848,1916,1932,3848,984,2835,20,,0.255717256,0.736746362,0.005197505,,,
Simpson County,Mississippi,28,127,28127,25817,12529,13288,25817,15810,9156,436,,0.612387187,0.354650037,0.016888097,,,
Smith County,Mississippi,28,129,28129,14193,6755,7438,14193,10476,3421,94,,0.738110336,0.241034313,0.006622983,,,
Stone County,Mississippi,28,131,28131,18515,9259,9256,18515,14174,3329,456,,0.765541453,0.179800162,0.024628679,,,
Sunflower County,Mississippi,28,133,28133,25328,13512,11816,25328,5937,18498,646,,0.234404611,0.730337966,0.02550537,,,
Tallahatchie County,Mississippi,28,135,28135,12363,6592,5771,12363,4470,7675,64,,0.361562727,0.620804012,0.005176737,,,
Tate County,Mississippi,28,137,28137,28135,13824,14311,28135,18700,8421,866,,0.664652568,0.299306913,0.030780167,,,
Tippah County,Mississippi,28,139,28139,21621,10340,11281,21621,16438,3183,1096,,0.760279358,0.147217983,0.050691457,,,
Tishomingo County,Mississippi,28,141,28141,18738,9215,9523,18738,17172,217,578,,0.916426513,0.011580745,0.030846408,,,
Tunica County,Mississippi,28,143,28143,9586,4546,5040,9586,1746,7630,230,,0.182140622,0.795952431,0.023993324,,,
Union County,Mississippi,28,145,28145,28009,13686,14323,28009,21547,4520,1342,,0.769288443,0.1613767,0.047913171,,,
Walthall County,Mississippi,28,147,28147,13864,6754,7110,13864,7361,5662,248,,0.530943451,0.408395845,0.017888055,,,
Warren County,Mississippi,28,149,28149,43623,20891,22732,43623,20363,21358,898,,0.466795039,0.489604108,0.020585471,,,
Washington County,Mississippi,28,151,28151,43674,20408,23266,43674,10598,31511,655,,0.242661538,0.721504785,0.014997481,,,
Wayne County,Mississippi,28,153,28153,19699,9519,10180,19699,11168,7318,747,,0.566932332,0.371490939,0.037920707,,,
Webster County,Mississippi,28,155,28155,9942,4720,5222,9942,7854,1845,178,,0.789981895,0.185576343,0.017903842,,,
Wilkinson County,Mississippi,28,157,28157,8376,4540,3836,8376,2366,5628,75,,0.282473734,0.671919771,0.008954155,,,
Winston County,Mississippi,28,159,28159,17609,8531,9078,17609,8745,8319,91,,0.496621046,0.472428872,0.005167812,,,
Yalobusha County,Mississippi,28,161,28161,12439,5887,6552,12439,7330,4559,202,,0.589275665,0.366508562,0.016239248,,,
Yazoo County,Mississippi,28,163,28163,26837,15495,11342,26837,10556,15594,1436,,0.393337556,0.581063457,0.053508216,,,
Adair County,Missouri,29,001,29001,25224,12253,12971,25224,22424,1059,721,,0.888994608,0.041983825,0.028583888,,,
Andrew County,Missouri,29,003,29003,18086,9085,9001,18086,16956,163,448,,0.937520734,0.009012496,0.024770541,,,
Atchison County,Missouri,29,005,29005,5216,2639,2577,5216,4919,19,94,,0.943059816,0.003642638,0.018021472,,,
Audrain County,Missouri,29,007,29007,24688,11740,12948,24688,22002,1167,767,,0.891202203,0.047269929,0.031067725,,,
Barry County,Missouri,29,009,29009,34831,17518,17313,34831,28530,92,3473,,0.81909793,0.002641325,0.099710028,,,
Barton County,Missouri,29,011,29011,11685,5817,5868,11685,10759,25,322,,0.920753102,0.002139495,0.027556697,,,
Bates County,Missouri,29,013,29013,16121,8144,7977,16121,15018,344,386,,0.931579927,0.021338627,0.023943924,,,
Benton County,Missouri,29,015,29015,19887,10127,9760,19887,18524,178,377,,0.931462765,0.008950571,0.018957108,,,
Bollinger County,Missouri,29,017,29017,10591,5258,5333,10591,10010,65,166,,0.945142102,0.006137286,0.015673685,,,
Boone County,Missouri,29,019,29019,185874,90116,95758,185874,144831,17737,8134,,0.779189128,0.095424858,0.043760827,,,
Buchanan County,Missouri,29,021,29021,83855,42462,41393,83855,68982,4812,5901,,0.822634309,0.057384771,0.070371475,,,
Butler County,Missouri,29,023,29023,42166,20556,21610,42166,36839,1943,994,,0.873665987,0.04607978,0.023573495,,,
Caldwell County,Missouri,29,025,29025,8890,4525,4365,8890,8281,105,192,,0.931496063,0.011811024,0.0215973,,,
Callaway County,Missouri,29,027,29027,44541,23032,21509,44541,39779,1520,1044,,0.893087268,0.034125862,0.023439079,,,
Camden County,Missouri,29,029,29029,43416,21565,21851,43416,40672,389,1453,,0.936797494,0.00895983,0.033466925,,,
Cape Girardeau County,Missouri,29,031,29031,82180,40147,42033,82180,70189,6650,2339,,0.854088586,0.080919932,0.028461913,,,
Carroll County,Missouri,29,033,29033,8459,4215,4244,8459,7973,125,174,,0.9425464,0.01477716,0.020569807,,,
Carter County,Missouri,29,035,29035,5269,2555,2714,5269,4902,33,108,,0.930347314,0.006263048,0.020497248,,,
Cass County,Missouri,29,037,29037,109393,53660,55733,109393,93594,4970,5828,,0.855575768,0.045432523,0.053275804,,,
Cedar County,Missouri,29,039,29039,14440,7383,7057,14440,13547,63,297,,0.938157895,0.004362881,0.020567867,,,
Chariton County,Missouri,29,041,29041,7406,3705,3701,7406,6914,199,67,,0.933567378,0.026870105,0.009046719,,,
Christian County,Missouri,29,043,29043,91229,44601,46628,91229,84186,714,3264,,0.922798671,0.007826459,0.035778097,,,
Clark County,Missouri,29,045,29045,6680,3412,3268,6680,6392,26,61,,0.956886228,0.003892216,0.009131737,,,
Clay County,Missouri,29,047,29047,255566,126284,129282,255566,204665,17320,19687,,0.800830314,0.067771143,0.077032939,,,
Clinton County,Missouri,29,049,29049,21259,10622,10637,21259,19810,157,543,,0.931840632,0.007385107,0.025542123,,,
Cole County,Missouri,29,051,29051,76924,38869,38055,76924,62304,8647,2721,,0.809942281,0.112409651,0.035372576,,,
Cooper County,Missouri,29,053,29053,16835,8451,8384,16835,14916,948,346,,0.886011286,0.056311256,0.020552421,,,
Crawford County,Missouri,29,055,29055,22890,11394,11496,22890,21498,137,526,,0.939187418,0.005985146,0.022979467,,,
Dade County,Missouri,29,057,29057,7627,3880,3747,7627,7135,29,162,,0.93549233,0.003802281,0.02124033,,,
Dallas County,Missouri,29,059,29059,17344,8515,8829,17344,16513,32,374,,0.952087177,0.001845018,0.021563653,,,
Daviess County,Missouri,29,061,29061,8449,4241,4208,8449,8114,76,144,,0.960350337,0.008995147,0.017043437,,,
DeKalb County,Missouri,29,063,29063,11176,6487,4689,11176,9863,742,262,,0.882516106,0.066392269,0.023443092,,,
Dent County,Missouri,29,065,29065,14506,7237,7269,14506,13376,83,308,,0.9221012,0.00572177,0.021232593,,,
Douglas County,Missouri,29,067,29067,11850,6010,5840,11850,10996,112,112,,0.927932489,0.009451477,0.009451477,,,
Dunklin County,Missouri,29,069,29069,27795,13293,14502,27795,21955,2184,2055,,0.789890268,0.078575283,0.073934161,,,
Franklin County,Missouri,29,071,29071,105316,52582,52734,105316,94575,872,2343,,0.898011698,0.008279844,0.022247332,,,
Gasconade County,Missouri,29,073,29073,14774,7506,7268,14774,14104,136,224,,0.954650061,0.009205361,0.015161771,,,
Gentry County,Missouri,29,075,29075,6224,3021,3203,6224,5981,23,112,,0.960957584,0.003695373,0.017994859,,,
Greene County,Missouri,29,077,29077,301121,147413,153708,301121,261044,8796,14950,,0.866907323,0.029210849,0.049647816,,,
Grundy County,Missouri,29,079,29079,9822,4809,5013,9822,9190,50,260,,0.935654653,0.005090613,0.026471187,,,
Harrison County,Missouri,29,081,29081,8198,4089,4109,8198,7868,62,191,,0.95974628,0.00756282,0.023298365,,,
Henry County,Missouri,29,083,29083,22194,10942,11252,22194,20633,160,650,,0.929665675,0.007209156,0.029287195,,,
Hickory County,Missouri,29,085,29085,8501,4297,4204,8501,8075,11,144,,0.949888248,0.001293965,0.016939184,,,
Holt County,Missouri,29,087,29087,4254,2115,2139,4254,4032,33,71,,0.947813822,0.007757405,0.016690174,,,
Howard County,Missouri,29,089,29089,10141,5023,5118,10141,8873,540,216,,0.874963021,0.053249186,0.021299675,,,
Howell County,Missouri,29,091,29091,40168,19584,20584,40168,37439,177,975,,0.932060347,0.004406493,0.024273053,,,
Iron County,Missouri,29,093,29093,9482,4716,4766,9482,8788,75,199,,0.92680869,0.007909724,0.020987134,,,
Jackson County,Missouri,29,095,29095,717021,348283,368738,717021,449853,161426,79383,,0.627391666,0.225134271,0.110712239,,,
Jasper County,Missouri,29,097,29097,123532,60660,62872,123532,105311,2201,11775,,0.852499757,0.017817246,0.095319431,,,
Jefferson County,Missouri,29,099,29099,228227,114066,114161,228227,205419,2432,5793,,0.90006441,0.010656057,0.025382623,,,
Johnson County,Missouri,29,101,29101,54331,27793,26538,54331,46858,2036,2742,,0.862454216,0.037474002,0.050468425,,,
Knox County,Missouri,29,103,29103,3760,1912,1848,3760,3584,34,14,,0.953191489,0.009042553,0.003723404,,,
Laclede County,Missouri,29,105,29105,36245,18171,18074,36245,33148,260,1033,,0.914553732,0.007173403,0.028500483,,,
Lafayette County,Missouri,29,107,29107,32974,16512,16462,32974,30218,574,1096,,0.916418997,0.017407655,0.033238309,,,
Lawrence County,Missouri,29,109,29109,38392,19320,19072,38392,34241,97,3161,,0.891878516,0.002526568,0.082334861,,,
Lewis County,Missouri,29,111,29111,9945,5100,4845,9945,9167,302,120,,0.921769734,0.030367019,0.012066365,,,
Lincoln County,Missouri,29,113,29113,61636,31067,30569,61636,57067,1171,1708,,0.925871244,0.018998637,0.027711078,,,
Linn County,Missouri,29,115,29115,11850,5813,6037,11850,11265,81,340,,0.950632911,0.006835443,0.028691983,,,
Livingston County,Missouri,29,117,29117,14330,6423,7907,14330,13197,423,273,,0.920935101,0.029518493,0.019050942,,,
McDonald County,Missouri,29,119,29119,23492,12046,11446,23492,16904,458,2880,,0.719564107,0.019495999,0.122594926,,,
Macon County,Missouri,29,121,29121,15163,7467,7696,15163,13992,359,276,,0.922772538,0.023676054,0.018202203,,,
Madison County,Missouri,29,123,29123,12665,6371,6294,12665,11936,49,335,,0.942439795,0.00386893,0.026450849,,,
Maries County,Missouri,29,125,29125,8435,4223,4212,8435,7883,14,160,,0.934558388,0.001659751,0.018968583,,,
Marion County,Missouri,29,127,29127,28493,13853,14640,28493,25518,1481,560,,0.89558839,0.051977679,0.01965395,,,
Mercer County,Missouri,29,129,29129,3501,1730,1771,3501,3247,9,155,,0.9274493,0.002570694,0.044273065,,,
Miller County,Missouri,29,131,29131,25081,12553,12528,25081,23881,299,516,,0.952155018,0.011921375,0.020573342,,,
Mississippi County,Missouri,29,133,29133,12079,6393,5686,12079,8680,2743,184,,0.718602533,0.227088335,0.015233049,,,
Moniteau County,Missouri,29,135,29135,15303,7909,7394,15303,13946,367,877,,0.911324577,0.023982226,0.057309024,,,
Monroe County,Missouri,29,137,29137,8672,4446,4226,8672,8059,350,151,,0.929312731,0.040359779,0.017412362,,,
Montgomery County,Missouri,29,139,29139,11422,5777,5645,11422,10658,214,252,,0.933111539,0.018735773,0.022062686,,,
Morgan County,Missouri,29,141,29141,21430,10831,10599,21430,20022,46,536,,0.934297713,0.002146524,0.025011666,,,
New Madrid County,Missouri,29,143,29143,16041,7642,8399,16041,12264,2041,286,,0.764540864,0.127236457,0.017829312,,,
Newton County,Missouri,29,145,29145,59490,29626,29864,59490,48927,557,3833,,0.822440746,0.009362918,0.064430997,,,
Nodaway County,Missouri,29,147,29147,20959,10375,10584,20959,19518,422,441,,0.93124672,0.020134548,0.02104108,,,
Oregon County,Missouri,29,149,29149,8704,4315,4389,8704,8153,7,114,,0.936695772,0.000804228,0.013097426,,,
Osage County,Missouri,29,151,29151,13379,6882,6497,13379,13083,21,141,,0.977875775,0.001569624,0.010538904,,,
Ozark County,Missouri,29,153,29153,8773,4421,4352,8773,8264,39,167,,0.941981078,0.004445458,0.019035678,,,
Pemiscot County,Missouri,29,155,29155,15232,7213,8019,15232,10096,3795,457,,0.662815126,0.249146534,0.030002626,,,
Perry County,Missouri,29,157,29157,18947,9424,9523,18947,17910,151,437,,0.94526838,0.007969599,0.023064337,,,
Pettis County,Missouri,29,159,29159,43205,21696,21509,43205,37031,1071,4135,,0.857099873,0.024788798,0.095706515,,,
Phelps County,Missouri,29,161,29161,44948,23429,21519,44948,39170,920,1328,,0.871451455,0.020468096,0.029545252,,,
Pike County,Missouri,29,163,29163,17623,9459,8164,17623,15752,844,225,,0.893831924,0.047891959,0.012767406,,,
Platte County,Missouri,29,165,29165,108751,53916,54835,108751,86636,8316,7535,,0.796645548,0.076468262,0.069286719,,,
Polk County,Missouri,29,167,29167,32109,15708,16401,32109,29850,262,898,,0.929645894,0.008159706,0.027967237,,,
Pulaski County,Missouri,29,169,29169,53850,29583,24267,53850,39136,5630,6190,,0.726759517,0.104549675,0.114948932,,,
Putnam County,Missouri,29,171,29171,4675,2392,2283,4675,4507,7,133,,0.964064171,0.001497326,0.028449198,,,
Ralls County,Missouri,29,173,29173,10394,5314,5080,10394,9713,194,123,,0.934481432,0.018664614,0.01183375,,,
Randolph County,Missouri,29,175,29175,24524,12738,11786,24524,21796,1220,596,,0.888762029,0.049747186,0.024302724,,,
Ray County,Missouri,29,177,29177,23149,11691,11458,23149,21578,273,643,,0.932135297,0.011793166,0.027776578,,,
Reynolds County,Missouri,29,179,29179,6058,3179,2879,6058,5564,90,102,,0.918454936,0.014856388,0.01683724,,,
Ripley County,Missouri,29,181,29181,10755,5351,5404,10755,10073,25,134,,0.936587634,0.0023245,0.012459321,,,
St. Charles County,Missouri,29,183,29183,409830,202660,207170,409830,348543,20698,16546,,0.850457507,0.050503867,0.040372838,,,
St. Clair County,Missouri,29,185,29185,9451,4797,4654,9451,8842,74,203,,0.935562374,0.007829859,0.021479209,,,
Ste. Genevieve County,Missouri,29,186,29186,18551,9534,9017,18551,17473,302,265,,0.941889925,0.016279446,0.014284944,,,
St. Francois County,Missouri,29,187,29187,66864,35219,31645,66864,61075,2014,1196,,0.913421273,0.030120842,0.017887054,,,
St. Louis County,Missouri,29,189,29189,996618,476813,519805,996618,627542,240688,37209,,0.629671549,0.241504769,0.037335268,,,
Saline County,Missouri,29,195,29195,23177,11773,11404,23177,18498,1091,2827,,0.798118825,0.047072529,0.121974371,,,
Schuyler County,Missouri,29,197,29197,4044,2001,2043,4044,3824,4,67,,0.945598417,0.00098912,0.016567755,,,
Scotland County,Missouri,29,199,29199,4698,2309,2389,4698,4542,4,4,,0.966794381,0.000851426,0.000851426,,,
Scott County,Missouri,29,201,29201,37967,18361,19606,37967,31312,4266,966,,0.824716201,0.112360734,0.025443148,,,
Shannon County,Missouri,29,203,29203,7137,3635,3502,7137,6615,17,37,,0.926860025,0.002381953,0.005184251,,,
Shelby County,Missouri,29,205,29205,6011,3041,2970,6011,5673,75,134,,0.943769755,0.012477125,0.022292464,,,
Stoddard County,Missouri,29,207,29207,28547,14087,14460,28547,26770,275,597,,0.937751778,0.009633236,0.020912881,,,
Stone County,Missouri,29,209,29209,31697,15718,15979,31697,29877,104,866,,0.942581317,0.003281068,0.027321198,,,
Sullivan County,Missouri,29,211,29211,5903,2975,2928,5903,4922,146,1051,,0.833813315,0.024733187,0.178045062,,,
Taney County,Missouri,29,213,29213,56382,27339,29043,56382,48996,931,4250,,0.869000745,0.016512362,0.075378667,,,
Texas County,Missouri,29,215,29215,24956,13221,11735,24956,22480,544,589,,0.900785382,0.021798365,0.023601539,,,
Vernon County,Missouri,29,217,29217,19713,9674,10039,19713,18657,151,493,,0.946431289,0.00765992,0.025008877,,,
Warren County,Missouri,29,219,29219,36467,18242,18225,36467,32859,779,1460,,0.901061233,0.021361779,0.040036197,,,
Washington County,Missouri,29,221,29221,23483,12175,11308,23483,21676,451,244,,0.923050718,0.019205383,0.010390495,,,
Wayne County,Missouri,29,223,29223,10942,5516,5426,10942,10238,42,113,,0.935660757,0.003838421,0.01032718,,,
Webster County,Missouri,29,225,29225,39868,20164,19704,39868,36858,455,882,,0.924500853,0.011412662,0.022123006,,,
Worth County,Missouri,29,227,29227,1956,993,963,1956,1894,2,37,,0.968302658,0.001022495,0.018916155,,,
Wright County,Missouri,29,229,29229,18722,9285,9437,18722,17450,35,460,,0.932058541,0.001869458,0.024570025,,,
St. Louis city,Missouri,29,510,29510,293109,142190,150919,293109,133985,126357,15005,,0.457116636,0.431092188,0.05119256,,,
Beaverhead County,Montana,30,001,30001,9590,4939,4651,9590,8852,59,472,,0.923044838,0.006152242,0.049217935,,,
Big Horn County,Montana,30,003,30003,12963,6376,6587,12963,3714,0,592,,0.286507753,0,0.045668441,,,
Blaine County,Montana,30,005,30005,6997,3491,3506,6997,3102,31,192,,0.443332857,0.00443047,0.027440332,,,
Broadwater County,Montana,30,007,30007,7310,3790,3520,7310,6595,27,131,,0.902188782,0.00369357,0.017920657,,,
Carbon County,Montana,30,009,30009,10877,5541,5336,10877,10120,50,311,,0.930403604,0.004596856,0.028592443,,,
Carter County,Montana,30,011,30011,1361,701,660,1361,1255,1,32,,0.922116091,0.000734754,0.023512123,,,
Cascade County,Montana,30,013,30013,84601,43115,41486,84601,71640,1232,4283,,0.846798501,0.014562476,0.050625879,,,
Chouteau County,Montana,30,015,30015,5888,2931,2957,5888,4612,8,178,,0.783288043,0.001358696,0.030230978,,,
Custer County,Montana,30,017,30017,11938,6034,5904,11938,10890,42,395,,0.912213101,0.003518177,0.033087619,,,
Daniels County,Montana,30,019,30019,1524,787,737,1524,1365,4,24,,0.895669291,0.002624672,0.015748031,,,
Dawson County,Montana,30,021,30021,8874,4669,4205,8874,8280,4,300,,0.93306288,0.000450755,0.033806626,,,
Deer Lodge County,Montana,30,023,30023,9512,5061,4451,9512,8622,30,320,,0.906433978,0.003153911,0.033641716,,,
Fallon County,Montana,30,025,30025,2817,1383,1434,2817,2614,1,16,,0.927937522,0.000354988,0.005679801,,,
Fergus County,Montana,30,027,30027,11581,5934,5647,11581,10797,74,256,,0.93230291,0.006389776,0.022105172,,,
Flathead County,Montana,30,029,30029,108445,54273,54172,108445,99139,275,3800,,0.914186915,0.002535848,0.035040804,,,
Gallatin County,Montana,30,031,30031,122194,63955,58239,122194,109567,593,6272,,0.896664321,0.004852939,0.051328216,,,
Garfield County,Montana,30,033,30033,938,467,471,938,917,9,0,,0.97761194,0.009594883,0,,,
Glacier County,Montana,30,035,30035,13713,6734,6979,13713,4179,23,378,,0.30474732,0.001677241,0.027565084,,,
Golden Valley County,Montana,30,037,30037,840,431,409,840,769,6,55,,0.91547619,0.007142857,0.06547619,,,
Granite County,Montana,30,039,30039,3419,1748,1671,3419,3170,25,66,,0.927171688,0.00731208,0.01930389,,,
Hill County,Montana,30,041,30041,16260,8287,7973,16260,11189,47,551,,0.688130381,0.002890529,0.033886839,,,
Jefferson County,Montana,30,043,30043,12501,6337,6164,12501,11602,14,339,,0.928085753,0.00111991,0.027117831,,,
Judith Basin County,Montana,30,045,30045,2053,1112,941,2053,1883,0,121,,0.91719435,0,0.058938139,,,
Lake County,Montana,30,047,30047,32073,15881,16192,32073,21050,67,1338,,0.656315281,0.002088985,0.041717332,,,
Lewis and Clark County,Montana,30,049,30049,72580,36100,36480,72580,66397,421,2830,,0.914811243,0.005800496,0.038991458,,,
Liberty County,Montana,30,051,30051,1968,895,1073,1968,1888,0,0,,0.959349593,0,0,,,
Lincoln County,Montana,30,053,30053,20656,10394,10262,20656,18912,15,614,,0.915569326,0.000726181,0.029725019,,,
McCone County,Montana,30,055,30055,1818,948,870,1818,1659,0,0,,0.912541254,0,0,,,
Madison County,Montana,30,057,30057,8975,4762,4213,8975,8314,0,317,,0.926350975,0,0.035320334,,,
Meagher County,Montana,30,059,30059,1979,1060,919,1979,1867,17,63,,0.94340576,0.008590197,0.03183426,,,
Mineral County,Montana,30,061,30061,4796,2536,2260,4796,4445,32,167,,0.926814012,0.006672227,0.034820684,,,
Missoula County,Montana,30,063,30063,119639,60127,59512,119639,104834,716,5902,,0.876252727,0.005984671,0.04933174,,,
Musselshell County,Montana,30,065,30065,5068,2614,2454,5068,4475,0,187,,0.882991318,0,0.036898185,,,
Park County,Montana,30,067,30067,17484,8806,8678,17484,16111,33,587,,0.921471059,0.00188744,0.033573553,,,
Petroleum County,Montana,30,069,30069,401,227,174,401,398,0,0,,0.992518703,0,0,,,
Phillips County,Montana,30,071,30071,4224,2249,1975,4224,3517,16,58,,0.832623106,0.003787879,0.013731061,,,
Pondera County,Montana,30,073,30073,6012,3025,2987,6012,4770,2,137,,0.793413174,0.000332668,0.022787758,,,
Powder River County,Montana,30,075,30075,1762,881,881,1762,1559,0,30,,0.884790011,0,0.017026107,,,
Powell County,Montana,30,077,30077,7029,4486,2543,7029,6190,87,160,,0.88063736,0.012377294,0.02276284,,,
Prairie County,Montana,30,079,30079,1251,675,576,1251,1123,0,10,,0.897681855,0,0.007993605,,,
Ravalli County,Montana,30,081,30081,45807,22960,22847,45807,41531,163,1820,,0.906651822,0.003558408,0.039731919,,,
Richland County,Montana,30,083,30083,11329,5696,5633,11329,10264,28,621,,0.905993468,0.002471533,0.054815076,,,
Roosevelt County,Montana,30,085,30085,10665,5372,5293,10665,3546,13,289,,0.332489451,0.00121894,0.027097984,,,
Rosebud County,Montana,30,087,30087,8236,4098,4138,8236,4472,14,285,,0.54298203,0.001699854,0.034604177,,,
Sanders County,Montana,30,089,30089,12936,6667,6269,12936,11620,68,432,,0.898268398,0.005256648,0.033395176,,,
Sheridan County,Montana,30,091,30091,3677,1952,1725,3677,3390,0,166,,0.92194724,0,0.045145499,,,
Silver Bow County,Montana,30,093,30093,35589,18414,17175,35589,32346,43,1639,,0.908876338,0.001208239,0.046053556,,,
Stillwater County,Montana,30,095,30095,9052,4543,4509,9052,8444,9,305,,0.932832523,0.000994255,0.033694211,,,
Sweet Grass County,Montana,30,097,30097,3713,1863,1850,3713,3363,50,66,,0.905736601,0.0134662,0.017775384,,,
Teton County,Montana,30,099,30099,6291,3091,3200,6291,5793,24,118,,0.920839294,0.003814974,0.018756954,,,
Toole County,Montana,30,101,30101,5028,3010,2018,5028,4269,93,217,,0.849045346,0.01849642,0.043158313,,,
Treasure County,Montana,30,103,30103,761,411,350,761,713,0,43,,0.936925099,0,0.056504599,,,
Valley County,Montana,30,105,30105,7540,3798,3742,7540,6404,46,193,,0.84933687,0.006100796,0.025596817,,,
Wheatland County,Montana,30,107,30107,2049,964,1085,2049,1960,27,55,,0.956564178,0.01317716,0.026842362,,,
Wibaux County,Montana,30,109,30109,1148,561,587,1148,1075,10,69,,0.93641115,0.008710801,0.06010453,,,
Yellowstone County,Montana,30,111,30111,167340,82873,84467,167340,145204,1466,10717,,0.867718418,0.008760607,0.064043265,,,
Adams County,Nebraska,31,001,31001,31034,15374,15660,31034,26449,421,3739,,0.852258813,0.013565767,0.120480763,,,
Antelope County,Nebraska,31,003,31003,6302,3189,3113,6302,5978,59,237,,0.94858775,0.009362107,0.037607109,,,
Arthur County,Nebraska,31,005,31005,540,293,247,540,500,0,3,,0.925925926,0,0.005555556,,,
Banner County,Nebraska,31,007,31007,657,304,353,657,609,0,29,,0.926940639,0,0.04414003,,,
Blaine County,Nebraska,31,009,31009,385,195,190,385,385,0,0,,1,0,0,,,
Boone County,Nebraska,31,011,31011,5366,2707,2659,5366,5109,1,207,,0.952105852,0.000186359,0.038576221,,,
Box Butte County,Nebraska,31,013,31013,10754,5492,5262,10754,9108,365,1321,,0.846940673,0.033940859,0.122838014,,,
Boyd County,Nebraska,31,015,31015,1704,898,806,1704,1572,5,67,,0.922535211,0.002934272,0.039319249,,,
Brown County,Nebraska,31,017,31017,2739,1371,1368,2739,2442,2,158,,0.891566265,0.000730194,0.057685287,,,
Buffalo County,Nebraska,31,019,31019,50323,25315,25008,50323,44164,453,5219,,0.877610635,0.009001848,0.103710033,,,
Burt County,Nebraska,31,021,31021,6730,3400,3330,6730,6163,30,218,,0.915750371,0.004457652,0.032392273,,,
Butler County,Nebraska,31,023,31023,8413,4214,4199,8413,7640,24,504,,0.908118388,0.002852728,0.059907286,,,
Cass County,Nebraska,31,025,31025,26963,13662,13301,26963,24880,44,1062,,0.922745985,0.001631866,0.039387309,,,
Cedar County,Nebraska,31,027,31027,8344,4284,4060,8344,8000,13,203,,0.958772771,0.001558006,0.024328859,,,
Chase County,Nebraska,31,029,31029,3639,1746,1893,3639,3127,16,668,,0.859302006,0.004396812,0.183566914,,,
Cherry County,Nebraska,31,031,31031,5468,2823,2645,5468,4679,53,164,,0.855705925,0.009692758,0.029992685,,,
Cheyenne County,Nebraska,31,033,31033,9478,4728,4750,9478,8720,196,790,,0.920025322,0.020679468,0.083350918,,,
Clay County,Nebraska,31,035,31035,6084,3108,2976,6084,5530,41,570,,0.908941486,0.006738988,0.093688363,,,
Colfax County,Nebraska,31,037,31037,10541,5735,4806,10541,5453,359,4983,,0.517313348,0.03405749,0.472725548,,,
Cuming County,Nebraska,31,039,31039,8976,4592,4384,8976,7804,39,1095,,0.86942959,0.00434492,0.121991979,,,
Custer County,Nebraska,31,041,31041,10544,5345,5199,10544,9907,54,396,,0.939586495,0.005121396,0.037556904,,,
Dakota County,Nebraska,31,043,31043,21331,10659,10672,21331,10181,1733,8780,,0.477286578,0.081243261,0.41160752,,,
Dawes County,Nebraska,31,045,31045,8212,3938,4274,8212,7277,111,391,,0.886142231,0.013516805,0.047613249,,,
Dawson County,Nebraska,31,047,31047,24020,12484,11536,24020,14899,1677,8720,,0.620274771,0.069816819,0.363030808,,,
Deuel County,Nebraska,31,049,31049,1865,925,940,1865,1684,0,188,,0.902949062,0,0.10080429,,,
Dixon County,Nebraska,31,051,31051,5561,2868,2693,5561,4652,16,838,,0.836540191,0.00287718,0.150692322,,,
Dodge County,Nebraska,31,053,31053,37146,18733,18413,37146,31958,195,6350,,0.860334895,0.005249556,0.170947074,,,
Douglas County,Nebraska,31,055,31055,585461,290649,294812,585461,414665,61984,82687,,0.708270918,0.105872125,0.141234002,,,
Dundy County,Nebraska,31,057,31057,1811,913,898,1811,1741,6,44,,0.961347322,0.003313087,0.024295969,,,
Fillmore County,Nebraska,31,059,31059,5551,2805,2746,5551,5261,15,204,,0.947757161,0.002702216,0.036750135,,,
Franklin County,Nebraska,31,061,31061,2868,1447,1421,2868,2705,7,90,,0.943165969,0.002440725,0.031380753,,,
Frontier County,Nebraska,31,063,31063,2562,1372,1190,2562,2389,30,96,,0.932474629,0.011709602,0.037470726,,,
Furnas County,Nebraska,31,065,31065,4605,2342,2263,4605,4355,13,233,,0.945711183,0.002823018,0.050597177,,,
Gage County,Nebraska,31,067,31067,21646,10952,10694,21646,20514,209,695,,0.947703964,0.009655364,0.032107549,,,
Garden County,Nebraska,31,069,31069,1620,791,829,1620,1536,1,53,,0.948148148,0.000617284,0.032716049,,,
Garfield County,Nebraska,31,071,31071,1797,897,900,1797,1750,7,38,,0.973845298,0.003895381,0.021146355,,,
Gosper County,Nebraska,31,073,31073,1929,1018,911,1929,1833,0,123,,0.950233281,0,0.063763608,,,
Grant County,Nebraska,31,075,31075,695,384,311,695,657,2,1,,0.945323741,0.002877698,0.001438849,,,
Greeley County,Nebraska,31,077,31077,2211,1144,1067,2211,2052,14,48,,0.928086839,0.006331976,0.021709634,,,
Hall County,Nebraska,31,079,31079,62431,31812,30619,62431,42584,2248,19563,,0.682097035,0.036007753,0.313353943,,,
Hamilton County,Nebraska,31,081,31081,9438,4744,4694,9438,8820,21,384,,0.934520025,0.002225048,0.040686586,,,
Harlan County,Nebraska,31,083,31083,3006,1536,1470,3006,2830,6,70,,0.941450432,0.001996008,0.02328676,,,
Hayes County,Nebraska,31,085,31085,854,416,438,854,792,0,55,,0.927400468,0,0.06440281,,,
Hitchcock County,Nebraska,31,087,31087,2601,1350,1251,2601,2473,2,101,,0.950788158,0.000768935,0.038831219,,,
Holt County,Nebraska,31,089,31089,10093,5049,5044,10093,9457,32,556,,0.93698603,0.003170514,0.055087685,,,
Hooker County,Nebraska,31,091,31091,613,311,302,613,534,11,0,,0.871125612,0.017944535,0,,,
Howard County,Nebraska,31,093,31093,6492,3296,3196,6492,6065,33,194,,0.934226741,0.005083179,0.029882933,,,
Jefferson County,Nebraska,31,095,31095,7155,3452,3703,7155,6680,45,379,,0.933612858,0.006289308,0.052969951,,,
Johnson County,Nebraska,31,097,31097,5263,3188,2075,5263,4206,245,615,,0.799163975,0.046551397,0.116853506,,,
Kearney County,Nebraska,31,099,31099,6697,3355,3342,6697,6234,2,434,,0.930864566,0.000298641,0.064805137,,,
Keith County,Nebraska,31,101,31101,8239,4125,4114,8239,7274,109,741,,0.882874135,0.013229761,0.089938099,,,
Keya Paha County,Nebraska,31,103,31103,939,468,471,939,881,1,34,,0.938232162,0.001064963,0.036208733,,,
Kimball County,Nebraska,31,105,31105,3348,1719,1629,3348,2916,44,332,,0.870967742,0.013142174,0.09916368,,,
Knox County,Nebraska,31,107,31107,8362,4166,4196,8362,7196,50,233,,0.860559675,0.005979431,0.027864147,,,
Lancaster County,Nebraska,31,109,31109,323673,162986,160687,323673,266343,12203,26670,,0.822876792,0.037701631,0.082397976,,,
Lincoln County,Nebraska,31,111,31111,34122,16997,17125,34122,30539,288,3099,,0.894994432,0.008440302,0.090821171,,,
Logan County,Nebraska,31,113,31113,812,417,395,812,732,13,11,,0.901477833,0.016009852,0.013546798,,,
Loup County,Nebraska,31,115,31115,564,319,245,564,486,0,53,,0.861702128,0,0.093971631,,,
McPherson County,Nebraska,31,117,31117,463,257,206,463,460,0,0,,0.993520518,0,0,,,
Madison County,Nebraska,31,119,31119,35535,17629,17906,35535,28939,322,5658,,0.814380189,0.009061489,0.159223301,,,
Merrick County,Nebraska,31,121,31121,7696,3944,3752,7696,7123,5,417,,0.925545738,0.000649688,0.054183992,,,
Morrill County,Nebraska,31,123,31123,4544,2366,2178,4544,3876,4,658,,0.852992958,0.000880282,0.144806338,,,
Nance County,Nebraska,31,125,31125,3342,1672,1670,3342,3177,11,78,,0.950628366,0.003291442,0.023339318,,,
Nemaha County,Nebraska,31,127,31127,7035,3602,3433,7035,6355,87,219,,0.903340441,0.012366738,0.031130064,,,
Nuckolls County,Nebraska,31,129,31129,4089,2036,2053,4089,3854,8,141,,0.942528736,0.001956469,0.034482759,,,
Otoe County,Nebraska,31,131,31131,16075,8283,7792,16075,14201,129,1331,,0.883421462,0.008024883,0.082799378,,,
Pawnee County,Nebraska,31,133,31133,2539,1246,1293,2539,2422,6,47,,0.953918866,0.002363135,0.018511225,,,
Perkins County,Nebraska,31,135,31135,2835,1462,1373,2835,2599,0,144,,0.91675485,0,0.050793651,,,
Phelps County,Nebraska,31,137,31137,8983,4562,4421,8983,8337,73,581,,0.928086385,0.008126461,0.064677725,,,
Pierce County,Nebraska,31,139,31139,7312,3710,3602,7312,6967,29,181,,0.952817287,0.003966083,0.024753829,,,
Platte County,Nebraska,31,141,31141,34358,17498,16860,34358,27362,279,7642,,0.7963793,0.00812038,0.222422725,,,
Polk County,Nebraska,31,143,31143,5209,2604,2605,5209,4801,4,301,,0.921674026,0.000767902,0.057784604,,,
Red Willow County,Nebraska,31,145,31145,10611,5332,5279,10611,9567,90,655,,0.901611535,0.008481764,0.061728395,,,
Richardson County,Nebraska,31,147,31147,7797,3933,3864,7797,7139,97,171,,0.915608567,0.012440682,0.021931512,,,
Rock County,Nebraska,31,149,31149,1335,661,674,1335,1315,2,6,,0.985018727,0.001498127,0.004494382,,,
Saline County,Nebraska,31,151,31151,14642,7501,7141,14642,10659,68,4203,,0.72797432,0.004644174,0.287050949,,,
Sarpy County,Nebraska,31,153,31153,194051,97827,96224,194051,158580,7930,21466,,0.817207847,0.040865546,0.110620404,,,
Saunders County,Nebraska,31,155,31155,22761,11684,11077,22761,21411,153,617,,0.940688019,0.006722025,0.027107772,,,
Scotts Bluff County,Nebraska,31,157,31157,35937,17389,18548,35937,28650,205,8420,,0.797228483,0.005704427,0.234298912,,,
Seward County,Nebraska,31,159,31159,17636,9066,8570,17636,16789,119,497,,0.951973237,0.006747562,0.028180993,,,
Sheridan County,Nebraska,31,161,31161,5058,2541,2517,5058,4152,31,260,,0.820877817,0.006128905,0.051403717,,,
Sherman County,Nebraska,31,163,31163,2974,1517,1457,2974,2793,19,78,,0.939139206,0.006388702,0.026227303,,,
Sioux County,Nebraska,31,165,31165,1197,595,602,1197,1134,4,46,,0.947368421,0.003341688,0.038429407,,,
Stanton County,Nebraska,31,167,31167,5835,2942,2893,5835,5317,12,388,,0.911225364,0.002056555,0.066495287,,,
Thayer County,Nebraska,31,169,31169,4938,2448,2490,4938,4650,5,153,,0.941676792,0.001012556,0.030984204,,,
Thomas County,Nebraska,31,171,31171,626,301,325,626,552,8,25,,0.881789137,0.012779553,0.039936102,,,
Thurston County,Nebraska,31,173,31173,6666,3288,3378,6666,2462,10,293,,0.369336934,0.00150015,0.043954395,,,
Valley County,Nebraska,31,175,31175,4094,2059,2035,4094,3943,6,107,,0.963116756,0.001465559,0.026135809,,,
Washington County,Nebraska,31,177,31177,20989,10480,10509,20989,19877,51,663,,0.947019868,0.002429844,0.031587975,,,
Wayne County,Nebraska,31,179,31179,9786,4976,4810,9786,8779,99,984,,0.897097895,0.010116493,0.100551809,,,
Webster County,Nebraska,31,181,31181,3385,1733,1652,3385,3170,5,186,,0.93648449,0.001477105,0.054948301,,,
Wheeler County,Nebraska,31,183,31183,785,394,391,785,764,0,15,,0.973248408,0,0.01910828,,,
York County,Nebraska,31,185,31185,14231,7166,7065,14231,12845,176,859,,0.902606985,0.012367367,0.060361183,,,
Churchill County,Nevada,32,001,32001,25614,13257,12357,25614,19398,650,3796,,0.757320216,0.025376747,0.148200203,,,
Clark County,Nevada,32,003,32003,2293764,1148112,1145652,2293764,1080706,278121,721337,,0.471149604,0.121250922,0.314477427,,,
Douglas County,Nevada,32,005,32005,49624,25045,24579,49624,40628,36,6329,,0.81871675,0.000725455,0.127539094,,,
Elko County,Nevada,32,007,32007,53852,28091,25761,53852,37506,459,13821,,0.696464384,0.00852336,0.25664785,,,
Esmeralda County,Nevada,32,009,32009,962,537,425,962,851,3,254,,0.884615385,0.003118503,0.264033264,,,
Eureka County,Nevada,32,011,32011,1660,991,669,1660,1406,2,49,,0.846987952,0.001204819,0.029518072,,,
Humboldt County,Nevada,32,013,32013,17299,8982,8317,17299,12507,120,4650,,0.722989768,0.006936817,0.268801665,,,
Lander County,Nevada,32,015,32015,5745,3043,2702,5745,4718,141,1266,,0.821235857,0.024543081,0.220365535,,,
Lincoln County,Nevada,32,017,32017,4452,2397,2055,4452,3811,186,235,,0.856019766,0.041778976,0.052785265,,,
Lyon County,Nevada,32,019,32019,60630,31508,29122,60630,46712,720,11331,,0.770443675,0.011875309,0.186887679,,,
Mineral County,Nevada,32,021,32021,4557,2106,2451,4557,2718,132,829,,0.59644503,0.028966425,0.181917928,,,
Nye County,Nevada,32,023,32023,53207,27039,26168,53207,40076,1375,8731,,0.753209164,0.025842464,0.16409495,,,
Pershing County,Nevada,32,027,32027,6505,4162,2343,6505,4783,276,1514,,0.735280553,0.042428901,0.232744043,,,
Storey County,Nevada,32,029,32029,4139,2211,1928,4139,3628,80,291,,0.876540227,0.01932834,0.070306837,,,
Washoe County,Nevada,32,031,32031,491770,249668,242102,491770,321970,11737,126068,,0.654716636,0.023866848,0.256355613,,,
White Pine County,Nevada,32,033,32033,8856,5051,3805,8856,6860,620,1451,,0.774616079,0.070009033,0.163843722,,,
Carson City,Nevada,32,510,32510,58364,30276,28088,58364,42024,1144,15105,,0.720032897,0.019601124,0.258806799,,,
Belknap County,New Hampshire,33,001,33001,64300,31781,32519,64300,60290,405,1387,,0.937636081,0.0062986,0.021570762,,,
Carroll County,New Hampshire,33,003,33003,51259,25893,25366,51259,48603,272,866,,0.948184709,0.005306385,0.016894594,,,
Cheshire County,New Hampshire,33,005,33005,76945,37894,39051,76945,71201,619,1904,,0.925349275,0.008044707,0.024744948,,,
Coos County,New Hampshire,33,007,33007,31386,16612,14774,31386,29611,536,715,,0.943446122,0.017077678,0.022780858,,,
Grafton County,New Hampshire,33,009,33009,91759,45512,46247,91759,81589,1221,2603,,0.889166185,0.013306597,0.02836779,,,
Hillsborough County,New Hampshire,33,011,33011,424732,212913,211819,424732,353822,10947,35041,,0.833047663,0.0257739,0.082501436,,,
Merrimack County,New Hampshire,33,013,33013,155018,77233,77785,155018,141676,2478,4083,,0.913932576,0.01598524,0.026338877,,,
Rockingham County,New Hampshire,33,015,33015,317163,157801,159362,317163,289993,2715,11178,,0.91433427,0.008560267,0.035243707,,,
Strafford County,New Hampshire,33,017,33017,131743,65071,66672,131743,117190,1600,4110,,0.889534928,0.012144858,0.031197103,,,
Sullivan County,New Hampshire,33,019,33019,43529,21858,21671,43529,40174,371,871,,0.922924947,0.008523054,0.020009649,,,
Atlantic County,New Jersey,34,001,34001,274704,133755,140949,274704,159688,38049,54686,,0.581309337,0.138509086,0.199072456,,,
Bergen County,New Jersey,34,003,34003,954717,467706,487011,954717,561302,54559,211044,,0.587925008,0.057146778,0.221053988,,,
Burlington County,New Jersey,34,005,34005,464226,229230,234996,464226,306469,76766,42820,,0.660171985,0.165363422,0.092239556,,,
Camden County,New Jersey,34,007,34007,524042,253745,270297,524042,295701,98859,97957,,0.564269658,0.188647093,0.186925857,,,
Cape May County,New Jersey,34,009,34009,95236,46213,49023,95236,82830,3237,7676,,0.869734134,0.033989248,0.080599773,,,
Cumberland County,New Jersey,34,011,34011,152915,78025,74890,152915,79484,27725,53457,,0.519792041,0.181309878,0.349586372,,,
Essex County,New Jersey,34,013,34013,854130,414880,439250,854130,283278,315154,210724,,0.331656774,0.368976619,0.246711859,,,
Gloucester County,New Jersey,34,015,34015,304504,149151,155353,304504,234706,32642,23885,,0.770781336,0.107197278,0.078439035,,,
Hudson County,New Jersey,34,017,34017,710478,354747,355731,710478,263094,86696,289220,,0.370305625,0.12202489,0.407078052,,,
Hunterdon County,New Jersey,34,019,34019,129448,63829,65619,129448,108341,3394,11451,,0.83694611,0.026219022,0.088460231,,,
Mercer County,New Jersey,34,021,34021,383286,189507,193779,383286,190842,73554,85269,,0.497910177,0.191903696,0.22246834,,,
Middlesex County,New Jersey,34,023,34023,861535,427818,433717,861535,381022,89702,198174,,0.442259456,0.104118811,0.230024317,,,
Monmouth County,New Jersey,34,025,34025,643615,315588,328027,643615,490314,39890,81564,,0.761812574,0.061978046,0.126727935,,,
Morris County,New Jersey,34,027,34027,510375,252947,257428,510375,362246,16787,78992,,0.709764389,0.032891501,0.154772471,,,
Ocean County,New Jersey,34,029,34029,646434,314617,331817,646434,549196,19534,68729,,0.849577838,0.030218089,0.106320212,,,
Passaic County,New Jersey,34,031,34031,518289,254516,263773,518289,242086,55055,225149,,0.467086896,0.10622452,0.434408216,,,
Salem County,New Jersey,34,033,34033,64973,31886,33087,64973,48173,9195,6975,,0.741431056,0.141520324,0.107352285,,,
Somerset County,New Jersey,34,035,34035,346203,170560,175643,346203,187337,33339,59019,,0.541118939,0.096298992,0.170475126,,,
Sussex County,New Jersey,34,037,34037,145117,72876,72241,145117,123044,3400,16039,,0.847895147,0.023429371,0.110524611,,,
Union County,New Jersey,34,039,34039,572549,282307,290242,572549,238727,117441,196795,,0.416954706,0.205119562,0.343717306,,,
Warren County,New Jersey,34,041,34041,110238,54768,55470,110238,88262,6075,13343,,0.800649504,0.055108039,0.121038118,,,
Bernalillo County,New Mexico,35,001,35001,674357,331669,342688,674357,369741,20435,329949,,0.548286738,0.03030294,0.489279417,,,
Catron County,New Mexico,35,003,35003,3685,1897,1788,3685,3136,14,559,,0.851017639,0.003799186,0.151696065,,,
Chaves County,New Mexico,35,005,35005,64446,32455,31991,64446,41179,964,37329,,0.638969059,0.01495826,0.579229122,,,
Cibola County,New Mexico,35,006,35006,27059,13504,13555,27059,9558,565,8925,,0.353228131,0.020880299,0.329834805,,,
Colfax County,New Mexico,35,007,35007,12336,6315,6021,12336,8356,76,5849,,0.677367056,0.00616083,0.474140726,,,
Curry County,New Mexico,35,009,35009,47932,24384,23548,47932,27847,2702,21782,,0.580968873,0.056371526,0.45443545,,,
De Baca County,New Mexico,35,011,35011,1580,997,583,1580,620,1,1004,,0.392405063,0.000632911,0.635443038,,,
Doña Ana County,New Mexico,35,013,35013,221665,109510,112155,221665,108334,3722,149893,,0.488728487,0.016791104,0.676214107,,,
Eddy County,New Mexico,35,015,35015,61114,31540,29574,61114,39641,892,31104,,0.648640246,0.014595674,0.508950486,,,
Grant County,New Mexico,35,017,35017,27856,14062,13794,27856,18685,186,13373,,0.670771109,0.006677197,0.480076106,,,
Guadalupe County,New Mexico,35,019,35019,4379,2548,1831,4379,1885,75,3263,,0.430463576,0.017127198,0.745147294,,,
Harding County,New Mexico,35,021,35021,748,365,383,748,378,13,304,,0.505347594,0.017379679,0.406417112,,,
Hidalgo County,New Mexico,35,023,35023,4097,1996,2101,4097,2606,0,2343,,0.636075177,0,0.571881865,,,
Lea County,New Mexico,35,025,35025,73154,37963,35191,73154,38233,2958,45091,,0.522637176,0.040435246,0.616384613,,,
Lincoln County,New Mexico,35,027,35027,20227,9893,10334,20227,14809,166,6591,,0.732140209,0.008206852,0.325851585,,,
Los Alamos County,New Mexico,35,028,35028,19374,9990,9384,19374,14782,233,3465,,0.762981315,0.012026427,0.178847941,,,
Luna County,New Mexico,35,029,35029,25420,12926,12494,25420,13967,484,16917,,0.549449253,0.019040126,0.665499607,,,
McKinley County,New Mexico,35,031,35031,71172,34336,36836,71172,6998,327,8649,,0.098325184,0.004594503,0.121522509,,,
Mora County,New Mexico,35,033,35033,4176,1874,2302,4176,2182,0,3178,,0.522509579,0,0.761015326,,,
Otero County,New Mexico,35,035,35035,68235,35767,32468,68235,40957,2490,26683,,0.600234484,0.036491537,0.391045651,,,
Quay County,New Mexico,35,037,35037,8616,4200,4416,8616,5609,135,3842,,0.650998143,0.015668524,0.445914578,,,
Rio Arriba County,New Mexico,35,039,35039,40165,19646,20519,40165,11213,299,27038,,0.27917341,0.007444292,0.673173161,,,
Roosevelt County,New Mexico,35,041,35041,19002,9507,9495,19002,13345,192,8440,,0.702294495,0.0101042,0.444163772,,,
Sandoval County,New Mexico,35,043,35043,151538,74972,76566,151538,85025,3322,59922,,0.561080389,0.021921894,0.39542557,,,
San Juan County,New Mexico,35,045,35045,121178,59893,61285,121178,51630,870,23890,,0.426067438,0.007179521,0.197147997,,,
San Miguel County,New Mexico,35,047,35047,27036,13247,13789,27036,13622,423,20367,,0.503846723,0.015645806,0.753328895,,,
Santa Fe County,New Mexico,35,049,35049,155175,75704,79471,155175,96125,1527,74485,,0.619461898,0.009840503,0.480006444,,,
Sierra County,New Mexico,35,051,35051,11511,5690,5821,11511,8477,27,3386,,0.736426027,0.002345582,0.294153418,,,
Socorro County,New Mexico,35,053,35053,16308,8127,8181,16308,8507,37,8196,,0.521645818,0.002268825,0.502575423,,,
Taos County,New Mexico,35,055,35055,34516,16922,17594,34516,20907,104,17530,,0.605719087,0.003013095,0.507880403,,,
Torrance County,New Mexico,35,057,35057,15290,7732,7558,15290,9540,374,6499,,0.623937214,0.024460432,0.425049052,,,
Union County,New Mexico,35,059,35059,4039,2181,1858,4039,2806,39,1603,,0.694726417,0.009655855,0.396880416,,,
Valencia County,New Mexico,35,061,35061,77382,38556,38826,77382,43171,1057,46872,,0.557894601,0.013659507,0.605722261,,,
Albany County,New York,36,001,36001,315374,153188,162186,315374,223239,38696,22163,,0.707854801,0.122698764,0.070275292,,,
Allegany County,New York,36,003,36003,47027,23865,23162,47027,44094,801,1002,,0.937631573,0.017032768,0.021306909,,,
Bronx County,New York,36,005,36005,1419250,670728,748522,1419250,223793,484151,779093,,0.157683988,0.341131584,0.548946979,,,
Broome County,New York,36,007,36007,197738,97684,100054,197738,161027,10789,10648,,0.814345245,0.054562097,0.053849033,,,
Cattaraugus County,New York,36,009,36009,76479,38307,38172,76479,68357,1125,1740,,0.893800913,0.01470992,0.022751344,,,
Cayuga County,New York,36,011,36011,75464,38666,36798,75464,66812,2314,2633,,0.885349306,0.030663628,0.034890809,,,
Chautauqua County,New York,36,013,36013,126329,62696,63633,126329,110294,3384,11792,,0.873069525,0.026787199,0.093343571,,,
Chemung County,New York,36,015,36015,82805,41061,41744,82805,71013,4913,2982,,0.857593141,0.059332166,0.036012318,,,
Chenango County,New York,36,017,36017,46685,23436,23249,46685,43747,284,1138,,0.937067581,0.006083324,0.024376138,,,
Clinton County,New York,36,019,36019,78961,40200,38761,78961,71102,2474,2714,,0.900469852,0.031331923,0.034371399,,,
Columbia County,New York,36,021,36021,61245,30964,30281,61245,51938,1981,3658,,0.848036574,0.032345498,0.059727325,,,
Cortland County,New York,36,023,36023,46401,23115,23286,46401,42001,978,1627,,0.905174457,0.021077132,0.035063899,,,
Delaware County,New York,36,025,36025,44551,22651,21900,44551,40429,698,2100,,0.907476824,0.015667437,0.047136989,,,
Dutchess County,New York,36,027,36027,297144,147902,149242,297144,210504,29383,44153,,0.708424198,0.098884716,0.148591255,,,
Erie County,New York,36,029,36029,950044,462208,487836,950044,708613,120580,59892,,0.745873875,0.126920437,0.063041291,,,
Essex County,New York,36,031,36031,37077,19096,17981,37077,34428,911,1026,,0.92855409,0.024570488,0.027672142,,,
Franklin County,New York,36,033,36033,47066,24685,22381,47066,39692,1597,1328,,0.843326393,0.033931076,0.028215697,,,
Fulton County,New York,36,035,36035,52787,26407,26380,52787,47443,807,2190,,0.898762953,0.015287855,0.041487487,,,
Genesee County,New York,36,037,36037,57943,29196,28747,57943,51950,1057,2743,,0.896570768,0.018242065,0.047339627,,,
Greene County,New York,36,039,36039,47554,24525,23029,47554,40619,2108,3135,,0.85416579,0.044328553,0.065925054,,,
Hamilton County,New York,36,041,36041,5102,2566,2536,5102,4694,49,101,,0.92003136,0.009604077,0.019796158,,,
Herkimer County,New York,36,043,36043,59932,29988,29944,59932,55543,584,1614,,0.926767003,0.009744377,0.026930521,,,
Jefferson County,New York,36,045,36045,116130,61091,55039,116130,96742,5802,8481,,0.833049169,0.04996125,0.073030225,,,
Kings County,New York,36,047,36047,2646306,1260397,1385909,2646306,1038877,767120,499799,,0.392576293,0.289883332,0.188866669,,,
Lewis County,New York,36,049,36049,26618,13486,13132,26618,25113,245,460,,0.943459313,0.009204298,0.017281539,,,
Livingston County,New York,36,051,36051,61588,30740,30848,61588,55619,1171,2759,,0.903081769,0.019013444,0.044797688,,,
Madison County,New York,36,053,36053,67572,33529,34043,67572,61737,1091,1718,,0.913647665,0.016145741,0.025424732,,,
Monroe County,New York,36,055,36055,754068,365903,388165,754068,536553,110298,73524,,0.711544582,0.146270628,0.097503143,,,
Montgomery County,New York,36,057,36057,49461,24581,24880,49461,41044,1540,7495,,0.829825519,0.031135642,0.151533531,,,
Nassau County,New York,36,059,36059,1388138,682628,705510,1388138,824058,157663,256452,,0.593642707,0.113578765,0.184745321,,,
New York County,New York,36,061,36061,1627788,777241,850547,1627788,820395,227801,395429,,0.503993763,0.139945128,0.24292414,,,
Niagara County,New York,36,063,36063,211341,103771,107570,211341,177330,13932,8151,,0.839070507,0.065921899,0.038568001,,,
Oneida County,New York,36,065,36065,229645,114649,114996,229645,187061,12818,15588,,0.814565961,0.055816586,0.067878682,,,
Onondaga County,New York,36,067,36067,471611,228849,242762,471611,358131,50946,27105,,0.759377962,0.10802547,0.057473214,,,
Ontario County,New York,36,069,36069,112405,55371,57034,112405,100594,2598,6260,,0.894924603,0.023112851,0.055691473,,,
Orange County,New York,36,071,36071,403840,201512,202328,403840,259798,46085,93608,,0.643319136,0.114116977,0.23179477,,,
Orleans County,New York,36,073,36073,39686,20095,19591,39686,34742,1832,2078,,0.875422063,0.046162375,0.052361034,,,
Oswego County,New York,36,075,36075,117945,59250,58695,117945,109406,1292,3778,,0.927601848,0.010954258,0.032031879,,,
Otsego County,New York,36,077,36077,59738,29039,30699,59738,53822,1405,2576,,0.900967558,0.023519368,0.043121631,,,
Putnam County,New York,36,079,36079,97988,49503,48485,97988,75621,3292,18676,,0.771737356,0.033595951,0.190594767,,,
Queens County,New York,36,081,36081,2330124,1138438,1191686,2330124,660474,405167,650071,,0.283450151,0.173882162,0.278985582,,,
Rensselaer County,New York,36,083,36083,160341,79903,80438,160341,130533,10825,9539,,0.814096207,0.067512364,0.059491958,,,
Richmond County,New York,36,085,36085,492734,241222,251512,492734,309682,48956,96147,,0.628497323,0.099355839,0.195129624,,,
Rockland County,New York,36,087,36087,338936,167624,171312,338936,217500,37424,67951,,0.64171407,0.110416126,0.200483277,,,
St. Lawrence County,New York,36,089,36089,107796,54976,52820,107796,99295,2118,2718,,0.921138076,0.019648224,0.025214294,,,
Saratoga County,New York,36,091,36091,237075,117659,119416,237075,211669,3890,9059,,0.892835601,0.01640831,0.038211536,,,
Schenectady County,New York,36,093,36093,159603,78365,81238,159603,112082,17273,12855,,0.70225497,0.108224783,0.080543599,,,
Schoharie County,New York,36,095,36095,29979,15054,14925,29979,27002,477,1165,,0.900697155,0.015911138,0.038860536,,,
Schuyler County,New York,36,097,36097,17749,8908,8841,17749,16600,190,350,,0.935263959,0.010704828,0.019719421,,,
Seneca County,New York,36,099,36099,33125,17132,15993,33125,29619,1260,1360,,0.894158491,0.038037736,0.041056604,,,
Steuben County,New York,36,101,36101,93034,46618,46416,93034,85865,1537,1754,,0.92294215,0.016520842,0.018853322,,,
Suffolk County,New York,36,103,36103,1525680,756551,769129,1525680,1051038,113159,338930,,0.688898065,0.074169551,0.222150123,,,
Sullivan County,New York,36,105,36105,79147,40993,38154,79147,56634,6918,14544,,0.715554601,0.087406977,0.183759334,,,
Tioga County,New York,36,107,36107,48106,24105,24001,48106,45044,536,1117,,0.936348896,0.011142061,0.023219557,,,
Tompkins County,New York,36,109,36109,102879,50408,52471,102879,78993,4105,6683,,0.767824337,0.039901243,0.064959807,,,
Ulster County,New York,36,111,36111,182109,90719,91390,182109,139093,11185,21562,,0.763789818,0.06141926,0.118401617,,,
Warren County,New York,36,113,36113,65560,32569,32991,65560,61144,824,1865,,0.932641855,0.012568639,0.028447224,,,
Washington County,New York,36,115,36115,60883,31286,29597,60883,55130,1504,1790,,0.905507284,0.024703119,0.029400654,,,
Wayne County,New York,36,117,36117,91128,45620,45508,91128,80916,2164,4625,,0.887937846,0.023746818,0.050752787,,,
Westchester County,New York,36,119,36119,996888,485985,510903,996888,545304,139205,269085,,0.547006284,0.139639558,0.269925007,,,
Wyoming County,New York,36,121,36121,39980,21429,18551,39980,35866,1532,1441,,0.897098549,0.03831916,0.036043022,,,
Yates County,New York,36,123,36123,24637,12084,12553,24637,23486,164,632,,0.95328165,0.006656655,0.025652474,,,
Alamance County,North Carolina,37,001,37001,174286,83490,90796,174286,109467,34710,25716,,0.628088315,0.199155411,0.147550578,,,
Alexander County,North Carolina,37,003,37003,36440,18750,17690,36440,31804,1468,1950,,0.872777168,0.040285401,0.053512623,,,
Alleghany County,North Carolina,37,005,37005,11075,5471,5604,11075,10115,164,1269,,0.913318284,0.014808126,0.114582393,,,
Anson County,North Carolina,37,007,37007,21903,10953,10950,21903,9924,10346,799,,0.453088618,0.472355385,0.036479021,,,
Ashe County,North Carolina,37,009,37009,26831,13232,13599,26831,25215,289,1569,,0.93977116,0.010771123,0.058477135,,,
Avery County,North Carolina,37,011,37011,17643,9632,8011,17643,15592,742,1005,,0.883749929,0.04205634,0.056963102,,,
Beaufort County,North Carolina,37,013,37013,44597,21195,23402,44597,30698,10181,3482,,0.688342265,0.228288898,0.078077001,,,
Bertie County,North Carolina,37,015,37015,17482,9050,8432,17482,6063,10498,379,,0.346813866,0.600503375,0.021679442,,,
Bladen County,North Carolina,37,017,37017,29591,14289,15302,29591,16248,9928,2650,,0.549085871,0.335507418,0.089554256,,,
Brunswick County,North Carolina,37,019,37019,145889,70235,75654,145889,120123,11808,8037,,0.823386273,0.080938248,0.055089829,,,
Buncombe County,North Carolina,37,021,37021,271790,131332,140458,271790,225935,14702,22443,,0.831285183,0.054093234,0.082574782,,,
Burke County,North Carolina,37,023,37023,87863,43940,43923,87863,71266,5320,7229,,0.81110365,0.060548809,0.082275816,,,
Cabarrus County,North Carolina,37,025,37025,231262,113450,117812,231262,143046,43654,28603,,0.6185452,0.188764259,0.123682231,,,
Caldwell County,North Carolina,37,027,37027,80618,40189,40429,80618,69846,3319,5160,,0.866382198,0.041169466,0.064005557,,,
Camden County,North Carolina,37,029,37029,10743,5307,5436,10743,8536,891,419,,0.794563902,0.082937727,0.039002141,,,
Carteret County,North Carolina,37,031,37031,68652,33593,35059,68652,59550,2998,3230,,0.867418284,0.043669522,0.047048884,,,
Caswell County,North Carolina,37,033,37033,22689,11797,10892,22689,13671,7138,1102,,0.602538675,0.314601789,0.048569792,,,
Catawba County,North Carolina,37,035,37035,162051,79678,82373,162051,122846,12975,17954,,0.75806999,0.080067386,0.110792281,,,
Chatham County,North Carolina,37,037,37037,78319,37897,40422,78319,56808,8238,10520,,0.725341233,0.105185204,0.13432245,,,
Cherokee County,North Carolina,37,039,37039,29197,14397,14800,29197,26633,449,1019,,0.912182759,0.015378292,0.034900846,,,
Chowan County,North Carolina,37,041,37041,13814,6772,7042,13814,8319,4593,534,,0.602215144,0.332488779,0.038656436,,,
Clay County,North Carolina,37,043,37043,11391,5537,5854,11391,10606,204,449,,0.931085945,0.017908875,0.039417084,,,
Cleveland County,North Carolina,37,045,37045,100170,48304,51866,100170,72654,18406,4426,,0.725306978,0.183747629,0.044184886,,,
Columbus County,North Carolina,37,047,37047,50453,24876,25577,50453,30351,14472,2766,,0.601569778,0.286841219,0.054823301,,,
Craven County,North Carolina,37,049,37049,101074,50355,50719,101074,68095,20493,7523,,0.673714308,0.202752439,0.074430615,,,
Cumberland County,North Carolina,37,051,37051,336749,167214,169535,336749,147878,125737,41644,,0.439134192,0.373384925,0.123664807,,,
Currituck County,North Carolina,37,053,37053,29612,14919,14693,29612,25360,1509,1444,,0.856409564,0.050959071,0.048764015,,,
Dare County,North Carolina,37,055,37055,37534,18439,19095,37534,32757,1052,2665,,0.872728726,0.028027921,0.071002291,,,
Davidson County,North Carolina,37,057,37057,171063,84115,86948,171063,135280,15898,14633,,0.790819756,0.09293652,0.085541584,,,
Davie County,North Carolina,37,059,37059,43526,21373,22153,43526,36669,1734,3493,,0.842461977,0.039838258,0.080250885,,,
Duplin County,North Carolina,37,061,37061,49053,24191,24862,49053,28190,11184,11137,,0.574684525,0.227998288,0.22704014,,,
Durham County,North Carolina,37,063,37063,329405,158119,171286,329405,149981,108885,50307,,0.455308814,0.330550538,0.152720815,,,
Edgecombe County,North Carolina,37,065,37065,48777,22900,25877,48777,18459,27272,2838,,0.378436558,0.559115977,0.05818316,,,
Forsyth County,North Carolina,37,067,37067,386740,183953,202787,386740,225043,98592,56553,,0.581897399,0.254930961,0.146230025,,,
Franklin County,North Carolina,37,069,37069,71962,35806,36156,71962,45327,17074,7637,,0.6298741,0.237264112,0.106125455,,,
Gaston County,North Carolina,37,071,37071,231485,112167,119318,231485,163004,40681,21518,,0.704166577,0.175739249,0.092956347,,,
Gates County,North Carolina,37,073,37073,10437,4977,5460,10437,6624,3254,219,,0.634665134,0.311775414,0.020983041,,,
Graham County,North Carolina,37,075,37075,8041,4037,4004,8041,6854,56,236,,0.852381545,0.006964308,0.029349583,,,
Granville County,North Carolina,37,077,37077,61439,31566,29873,61439,35065,18098,6545,,0.57072869,0.294568596,0.106528427,,,
Greene County,North Carolina,37,079,37079,20421,11740,8681,20421,10071,6570,3077,,0.493168797,0.321727633,0.150678223,,,
Guilford County,North Carolina,37,081,37081,542987,257783,285204,542987,266751,184691,53188,,0.491265905,0.340138898,0.097954463,,,
Halifax County,North Carolina,37,083,37083,48219,23444,24775,48219,17937,25038,1558,,0.371990294,0.519255895,0.032310915,,,
Harnett County,North Carolina,37,085,37085,136503,67703,68800,136503,85935,28377,19970,,0.629546603,0.207885541,0.146297151,,,
Haywood County,North Carolina,37,087,37087,62432,30468,31964,62432,57353,624,2953,,0.918647488,0.009994874,0.047299462,,,
Henderson County,North Carolina,37,089,37089,117387,56796,60591,117387,98766,3842,15034,,0.84137085,0.032729348,0.128072103,,,
Hertford County,North Carolina,37,091,37091,20492,10050,10442,20492,7206,11636,1328,,0.351649424,0.567831349,0.064805778,,,
Hoke County,North Carolina,37,093,37093,53102,26207,26895,53102,21680,17797,8106,,0.408270875,0.335147452,0.152649618,,,
Hyde County,North Carolina,37,095,37095,4625,2523,2102,4625,2808,1154,358,,0.607135135,0.249513514,0.077405405,,,
Iredell County,North Carolina,37,097,37097,191800,95016,96784,191800,144865,22203,17001,,0.755291971,0.11576121,0.088639208,,,
Jackson County,North Carolina,37,099,37099,43089,21255,21834,43089,34250,1021,3310,,0.794866439,0.023695143,0.076817749,,,
Johnston County,North Carolina,37,101,37101,226623,111795,114828,226623,151028,37620,36811,,0.666428385,0.166002568,0.162432763,,,
Jones County,North Carolina,37,103,37103,9245,4576,4669,9245,5857,2523,441,,0.633531639,0.272904273,0.04770146,,,
Lee County,North Carolina,37,105,37105,64565,31805,32760,64565,42408,11995,13590,,0.656826454,0.18578177,0.210485557,,,
Lenoir County,North Carolina,37,107,37107,54917,26207,28710,54917,27779,21799,4620,,0.50583608,0.39694448,0.084126955,,,
Lincoln County,North Carolina,37,109,37109,90359,44938,45421,90359,76579,5271,7065,,0.847497206,0.058333979,0.078188116,,,
McDowell County,North Carolina,37,111,37111,44679,22442,22237,44679,39523,1730,3028,,0.884599029,0.038720652,0.067772332,,,
Macon County,North Carolina,37,113,37113,37533,18462,19071,37533,33271,446,3634,,0.886446594,0.011882876,0.096821464,,,
Madison County,North Carolina,37,115,37115,21640,10747,10893,21640,19915,223,759,,0.920286506,0.010304991,0.035073937,,,
Martin County,North Carolina,37,117,37117,21773,10076,11697,21773,11239,8934,939,,0.516189776,0.410324714,0.043126808,,,
Mecklenburg County,North Carolina,37,119,37119,1130906,546522,584384,1130906,526435,344569,174580,,0.465498459,0.304684032,0.154371805,,,
Mitchell County,North Carolina,37,121,37121,14973,7375,7598,14973,13794,118,790,,0.921258265,0.007880852,0.052761638,,,
Montgomery County,North Carolina,37,123,37123,25874,12714,13160,25874,17289,4318,4000,,0.668199737,0.166885677,0.154595347,,,
Moore County,North Carolina,37,125,37125,102840,50300,52540,102840,80209,9898,7799,,0.779939712,0.096246597,0.07583625,,,
Nash County,North Carolina,37,127,37127,95451,46022,49429,95451,46001,38787,7578,,0.481933138,0.406355093,0.07939152,,,
New Hanover County,North Carolina,37,129,37129,231214,110318,120896,231214,178985,26060,17675,,0.774109699,0.112709438,0.076444333,,,
Northampton County,North Carolina,37,131,37131,17212,8339,8873,17212,6827,9451,398,,0.396641878,0.549093656,0.023123402,,,
Onslow County,North Carolina,37,133,37133,208537,116322,92215,208537,144394,26157,28739,,0.692414296,0.125430979,0.137812475,,,
Orange County,North Carolina,37,135,37135,147292,70440,76852,147292,103797,15595,15540,,0.704702224,0.10587812,0.105504712,,,
Pamlico County,North Carolina,37,137,37137,12315,6351,5964,12315,9184,2286,567,,0.745757207,0.185627284,0.046041413,,,
Pasquotank County,North Carolina,37,139,37139,40830,20053,20777,40830,22691,14361,2401,,0.555743326,0.351726672,0.0588048,,,
Pender County,North Carolina,37,141,37141,63475,32136,31339,63475,48080,7847,5402,,0.757463568,0.123623474,0.085104372,,,
Perquimans County,North Carolina,37,143,37143,13146,6347,6799,13146,9243,2861,391,,0.703103606,0.21763274,0.029742888,,,
Person County,North Carolina,37,145,37145,39275,18940,20335,39275,25796,10004,2303,,0.656804583,0.254716741,0.05863781,,,
Pitt County,North Carolina,37,147,37147,172279,80991,91288,172279,91243,60469,13263,,0.52962346,0.350994608,0.076985587,,,
Polk County,North Carolina,37,149,37149,19689,9364,10325,19689,17269,1002,1075,,0.87708873,0.050891361,0.054599015,,,
Randolph County,North Carolina,37,151,37151,145322,72279,73043,145322,116545,8907,19722,,0.801977677,0.061291477,0.135712418,,,
Richmond County,North Carolina,37,153,37153,42818,20779,22039,42818,24360,13599,3222,,0.568919613,0.317600075,0.075248727,,,
Robeson County,North Carolina,37,155,37155,116858,56378,60480,116858,29029,27233,12216,,0.248412603,0.233043523,0.104537131,,,
Rockingham County,North Carolina,37,157,37157,91585,44782,46803,91585,66525,16112,6308,,0.726374406,0.175924005,0.068875908,,,
Rowan County,North Carolina,37,159,37159,148487,73722,74765,148487,105910,23278,16784,,0.713261094,0.156767933,0.113033464,,,
Rutherford County,North Carolina,37,161,37161,64850,31534,33316,64850,53801,5240,3533,,0.829622205,0.08080185,0.054479568,,,
Sampson County,North Carolina,37,163,37163,59245,29578,29667,59245,31539,14768,12600,,0.532348721,0.249269981,0.212676175,,,
Scotland County,North Carolina,37,165,37165,34353,17714,16639,34353,14094,12973,1272,,0.410269845,0.377638052,0.037027334,,,
Stanly County,North Carolina,37,167,37167,63557,31854,31703,63557,51072,6998,3341,,0.803562157,0.110105889,0.052566987,,,
Stokes County,North Carolina,37,169,37169,44889,22040,22849,44889,40992,1543,1621,,0.913185858,0.034373677,0.036111297,,,
Surry County,North Carolina,37,171,37171,71407,34802,36605,71407,61533,2680,8674,,0.86172224,0.037531334,0.121472685,,,
Swain County,North Carolina,37,173,37173,14065,6792,7273,14065,8601,212,718,,0.611517952,0.015072876,0.051048702,,,
Transylvania County,North Carolina,37,175,37175,33243,16098,17145,33243,29675,1302,1635,,0.892669133,0.03916614,0.049183287,,,
Tyrrell County,North Carolina,37,177,37177,3376,1759,1617,3376,1903,1103,337,,0.563684834,0.326718009,0.099822275,,,
Union County,North Carolina,37,179,37179,244975,121676,123299,244975,174145,27397,31683,,0.710868456,0.111835902,0.129331564,,,
Vance County,North Carolina,37,181,37181,42361,19734,22627,42361,16307,20746,3853,,0.384953141,0.489742924,0.090956304,,,
Wake County,North Carolina,37,183,37183,1151009,563678,587331,1151009,683568,221985,131104,,0.593885886,0.19286122,0.11390354,,,
Warren County,North Carolina,37,185,37185,18751,9237,9514,18751,7215,8826,830,,0.384779478,0.470694896,0.044264306,,,
Washington County,North Carolina,37,187,37187,10905,5460,5445,10905,5082,5411,426,,0.466024759,0.496194406,0.039064649,,,
Watauga County,North Carolina,37,189,37189,54607,27240,27367,54607,49334,1194,3303,,0.903437288,0.021865329,0.060486751,,,
Wayne County,North Carolina,37,191,37191,117606,58449,59157,117606,64683,35979,15495,,0.549997449,0.305928269,0.131753482,,,
Wilkes County,North Carolina,37,193,37193,65983,32769,33214,65983,57561,2461,4785,,0.872361063,0.037297486,0.072518679,,,
Wilson County,North Carolina,37,195,37195,78648,37533,41115,78648,36231,30889,9354,,0.460672872,0.392749975,0.118935002,,,
Yadkin County,North Carolina,37,197,37197,37419,18696,18723,37419,32254,1095,4510,,0.861968519,0.029263209,0.120527005,,,
Yancey County,North Carolina,37,199,37199,18676,9240,9436,18676,17268,109,1051,,0.924609124,0.005836368,0.056275434,,,
Adams County,North Dakota,38,001,38001,2179,1136,1043,2179,1917,15,98,,0.879761358,0.006883892,0.044974759,,,
Barnes County,North Dakota,38,003,38003,10794,5447,5347,10794,9823,137,215,,0.910042616,0.012692236,0.019918473,,,
Benson County,North Dakota,38,005,38005,5861,3022,2839,5861,2519,32,98,,0.429790138,0.005459819,0.016720696,,,
Billings County,North Dakota,38,007,38007,948,511,437,948,937,0,35,,0.988396624,0,0.036919831,,,
Bottineau County,North Dakota,38,009,38009,6390,3314,3076,6390,5806,27,156,,0.908607199,0.004225352,0.024413146,,,
Bowman County,North Dakota,38,011,38011,2935,1489,1446,2935,2766,0,137,,0.94241908,0,0.046678024,,,
Burke County,North Dakota,38,013,38013,2163,1147,1016,2163,1981,16,19,,0.915857605,0.007397134,0.008784096,,,
Burleigh County,North Dakota,38,015,38015,98986,49611,49375,98986,85701,1869,3244,,0.865789101,0.018881458,0.032772311,,,
Cass County,North Dakota,38,017,38017,189286,95886,93400,189286,158063,12256,6576,,0.835048551,0.064748582,0.03474108,,,
Cavalier County,North Dakota,38,019,38019,3663,1910,1753,3663,3400,0,97,,0.928200928,0,0.026481026,,,
Dickey County,North Dakota,38,021,38021,4959,2527,2432,4959,4595,14,194,,0.926598104,0.00282315,0.03912079,,,
Divide County,North Dakota,38,023,38023,2174,1123,1051,2174,1944,77,121,,0.894204232,0.035418583,0.055657774,,,
Dunn County,North Dakota,38,025,38025,4043,2214,1829,4043,3320,23,151,,0.821172397,0.005688845,0.037348504,,,
Eddy County,North Dakota,38,027,38027,2319,1208,1111,2319,2116,0,91,,0.912462268,0,0.039241052,,,
Emmons County,North Dakota,38,029,38029,3269,1636,1633,3269,3084,2,31,,0.94340777,0.000611808,0.009483022,,,
Foster County,North Dakota,38,031,38031,3372,1725,1647,3372,3178,12,28,,0.942467378,0.003558719,0.008303677,,,
Golden Valley County,North Dakota,38,033,38033,1679,842,837,1679,1532,1,27,,0.912447886,0.000595593,0.016081001,,,
Grand Forks County,North Dakota,38,035,38035,72764,37451,35313,72764,61065,2615,3783,,0.839219944,0.035938101,0.051989995,,,
Grant County,North Dakota,38,037,38037,2276,1127,1149,2276,2131,2,21,,0.93629174,0.000878735,0.009226714,,,
Griggs County,North Dakota,38,039,38039,2340,1199,1141,2340,2219,27,30,,0.948290598,0.011538462,0.012820513,,,
Hettinger County,North Dakota,38,041,38041,2453,1193,1260,2453,2328,8,3,,0.949041989,0.003261313,0.001222992,,,
Kidder County,North Dakota,38,043,38043,2374,1343,1031,2374,2284,5,69,,0.962089301,0.00210615,0.029064869,,,
LaMoure County,North Dakota,38,045,38045,4107,2122,1985,4107,3946,11,82,,0.960798636,0.002678354,0.019965912,,,
Logan County,North Dakota,38,047,38047,1848,954,894,1848,1740,1,58,,0.941558442,0.000541126,0.031385281,,,
McHenry County,North Dakota,38,049,38049,5264,2723,2541,5264,5012,37,115,,0.95212766,0.007028875,0.021846505,,,
McIntosh County,North Dakota,38,051,38051,2512,1258,1254,2512,2324,2,74,,0.925159236,0.000796178,0.029458599,,,
McKenzie County,North Dakota,38,053,38053,14280,7691,6589,14280,11438,306,1602,,0.800980392,0.021428571,0.112184874,,,
McLean County,North Dakota,38,055,38055,9807,5063,4744,9807,8709,16,194,,0.888039156,0.001631488,0.019781789,,,
Mercer County,North Dakota,38,057,38057,8341,4232,4109,8341,7587,50,225,,0.909603165,0.005994485,0.026975183,,,
Morton County,North Dakota,38,059,38059,33479,16847,16632,33479,29414,582,1413,,0.878580603,0.017384032,0.042205562,,,
Mountrail County,North Dakota,38,061,38061,9567,4979,4588,9567,5725,192,788,,0.598411205,0.020068987,0.082366468,,,
Nelson County,North Dakota,38,063,38063,3015,1509,1506,3015,2813,0,86,,0.933001658,0,0.028524046,,,
Oliver County,North Dakota,38,065,38065,1821,989,832,1821,1674,0,55,,0.919275124,0,0.030203185,,,
Pembina County,North Dakota,38,067,38067,6787,3660,3127,6787,6128,65,270,,0.902902608,0.009577133,0.039781936,,,
Pierce County,North Dakota,38,069,38069,3961,1965,1996,3961,3696,11,42,,0.933097703,0.002777076,0.010603383,,,
Ramsey County,North Dakota,38,071,38071,11563,5783,5780,11563,9496,119,320,,0.821240163,0.010291447,0.027674479,,,
Ransom County,North Dakota,38,073,38073,5662,2944,2718,5662,5251,49,152,,0.927410809,0.008654186,0.026845638,,,
Renville County,North Dakota,38,075,38075,2277,1162,1115,2277,2205,0,21,,0.968379447,0,0.009222661,,,
Richland County,North Dakota,38,077,38077,16550,8465,8085,16550,14917,155,610,,0.901329305,0.009365559,0.036858006,,,
Rolette County,North Dakota,38,079,38079,12065,5974,6091,12065,2237,24,128,,0.18541235,0.001989225,0.0106092,,,
Sargent County,North Dakota,38,081,38081,3822,2089,1733,3822,3468,105,110,,0.907378336,0.027472527,0.028780743,,,
Sheridan County,North Dakota,38,083,38083,1327,652,675,1327,1270,0,5,,0.957045968,0,0.003767898,,,
Sioux County,North Dakota,38,085,38085,3789,1892,1897,3789,468,7,38,,0.123515439,0.001847453,0.010029031,,,
Slope County,North Dakota,38,087,38087,795,432,363,795,746,0,1,,0.93836478,0,0.001257862,,,
Stark County,North Dakota,38,089,38089,33116,17381,15735,33116,28728,777,2304,,0.867496074,0.023462979,0.06957362,,,
Steele County,North Dakota,38,091,38091,1731,889,842,1731,1629,5,45,,0.941074523,0.002888504,0.025996534,,,
Stutsman County,North Dakota,38,093,38093,21525,11003,10522,21525,19793,461,635,,0.919535424,0.021416957,0.029500581,,,
Towner County,North Dakota,38,095,38095,2113,1071,1042,2113,1786,15,79,,0.845243729,0.007098912,0.037387601,,,
Traill County,North Dakota,38,097,38097,7980,4123,3857,7980,7270,69,299,,0.911027569,0.008646617,0.037468672,,,
Walsh County,North Dakota,38,099,38099,10488,5308,5180,10488,8941,92,1332,,0.852498093,0.00877193,0.127002288,,,
Ward County,North Dakota,38,101,38101,69232,36109,33123,69232,56909,2861,4800,,0.822004275,0.041324821,0.069332101,,,
Wells County,North Dakota,38,103,38103,3942,1913,2029,3942,3804,0,50,,0.96499239,0,0.012683917,,,
Williams County,North Dakota,38,105,38105,39368,20883,18485,39368,31987,2059,3806,,0.812512701,0.052301362,0.096677505,,,
Adams County,Ohio,39,001,39001,27510,13672,13838,27510,26555,118,245,,0.965285351,0.004289349,0.008905852,,,
Allen County,Ohio,39,003,39003,101685,50817,50868,101685,82251,10805,3501,,0.808880366,0.106259527,0.034429857,,,
Ashland County,Ohio,39,005,39005,52296,26051,26245,52296,49708,599,886,,0.950512467,0.011454031,0.016942022,,,
Ashtabula County,Ohio,39,007,39007,97343,49821,47522,97343,87215,3708,4673,,0.895955539,0.038092107,0.048005506,,,
Athens County,Ohio,39,009,39009,61573,30787,30786,61573,55819,1538,1380,,0.906549949,0.024978481,0.022412421,,,
Auglaize County,Ohio,39,011,39011,46209,23117,23092,46209,44061,410,828,,0.953515549,0.00887273,0.017918587,,,
Belmont County,Ohio,39,013,39013,65982,34190,31792,65982,60286,2040,837,,0.913673426,0.030917523,0.012685278,,,
Brown County,Ohio,39,015,39015,43710,21835,21875,43710,41826,379,529,,0.956897735,0.008670785,0.012102494,,,
Butler County,Ohio,39,017,39017,389910,192522,197388,389910,303855,32333,25823,,0.779295222,0.082924265,0.066228104,,,
Carroll County,Ohio,39,019,39019,26731,13604,13127,26731,25414,195,337,,0.950731361,0.007294901,0.012607085,,,
Champaign County,Ohio,39,021,39021,38772,19305,19467,38772,35795,661,683,,0.923217786,0.017048385,0.017615805,,,
Clark County,Ohio,39,023,39023,135445,66490,68955,135445,113146,11136,5481,,0.835364908,0.082217874,0.04046661,,,
Clermont County,Ohio,39,025,39025,209862,104060,105802,209862,193999,3119,5131,,0.924412233,0.014862148,0.0244494,,,
Clinton County,Ohio,39,027,39027,42014,20833,21181,42014,38887,786,869,,0.925572428,0.01870805,0.020683582,,,
Columbiana County,Ohio,39,029,39029,101203,51270,49933,101203,94309,1937,1871,,0.93187949,0.019139749,0.018487594,,,
Coshocton County,Ohio,39,031,39031,36679,18218,18461,36679,34746,257,94,,0.947299545,0.007006734,0.002562774,,,
Crawford County,Ohio,39,033,39033,41767,20590,21177,41767,39873,357,724,,0.954653195,0.008547418,0.017334259,,,
Cuyahoga County,Ohio,39,035,39035,1249418,599391,650027,1249418,733835,362015,84864,,0.587341466,0.289746906,0.067922825,,,
Darke County,Ohio,39,037,39037,51655,25824,25831,51655,49378,283,924,,0.955919079,0.005478656,0.01788791,,,
Defiance County,Ohio,39,039,39039,38258,19212,19046,38258,33909,646,4096,,0.886324429,0.016885357,0.107062575,,,
Delaware County,Ohio,39,041,39041,221160,110668,110492,221160,179940,9233,7373,,0.813619099,0.041748056,0.033337855,,,
Erie County,Ohio,39,043,39043,74938,36750,38188,74938,61587,6334,3299,,0.821839387,0.084523206,0.044023059,,,
Fairfield County,Ohio,39,045,39045,161289,80584,80705,161289,133267,14324,4294,,0.826262175,0.088809528,0.026623018,,,
Fayette County,Ohio,39,047,39047,28880,14271,14609,28880,26377,841,699,,0.913331025,0.029120499,0.024203601,,,
Franklin County,Ohio,39,049,39049,1321635,649003,672632,1321635,799189,304406,93630,,0.604697212,0.230325317,0.070844068,,,
Fulton County,Ohio,39,051,39051,42434,21239,21195,42434,38328,168,3873,,0.90323797,0.003959089,0.09127115,,,
Gallia County,Ohio,39,053,39053,29162,14378,14784,29162,26953,582,300,,0.924250737,0.019957479,0.01028736,,,
Geauga County,Ohio,39,055,39055,95479,47764,47715,95479,89461,898,1775,,0.936970433,0.00940521,0.018590475,,,
Greene County,Ohio,39,057,39057,168531,83666,84865,168531,139641,9916,5418,,0.828577532,0.05883784,0.032148388,,,
Guernsey County,Ohio,39,059,39059,38283,19101,19182,38283,36041,633,491,,0.941436147,0.016534754,0.012825536,,,
Hamilton County,Ohio,39,061,39061,827878,401948,425930,827878,532630,207806,37415,,0.643367743,0.251010415,0.045193857,,,
Hancock County,Ohio,39,063,39063,74885,37084,37801,74885,67314,1371,4389,,0.898898311,0.018308072,0.058609868,,,
Hardin County,Ohio,39,065,39065,30527,15127,15400,30527,28513,344,701,,0.934025617,0.011268713,0.022963278,,,
Harrison County,Ohio,39,067,39067,14408,7123,7285,14408,13647,411,162,,0.947182121,0.028525819,0.011243753,,,
Henry County,Ohio,39,069,39069,27581,13794,13787,27581,24729,169,2232,,0.896595482,0.006127407,0.080925275,,,
Highland County,Ohio,39,071,39071,43403,21339,22064,43403,41220,509,492,,0.949703938,0.0117273,0.011335622,,,
Hocking County,Ohio,39,073,39073,27938,14022,13916,27938,26370,110,260,,0.943875725,0.00393729,0.009306321,,,
Holmes County,Ohio,39,075,39075,44312,22360,21952,44312,43462,70,469,,0.980817837,0.001579708,0.01058404,,,
Huron County,Ohio,39,077,39077,58412,29011,29401,58412,53682,436,4177,,0.919023488,0.00746422,0.071509279,,,
Jackson County,Ohio,39,079,39079,32588,16075,16513,32588,31347,324,318,,0.961918498,0.00994231,0.009758193,,,
Jefferson County,Ohio,39,081,39081,64855,31820,33035,64855,58133,3485,1180,,0.896353404,0.053735256,0.018194434,,,
Knox County,Ohio,39,083,39083,62888,31021,31867,62888,59089,590,1233,,0.939591019,0.009381758,0.019606284,,,
Lake County,Ohio,39,085,39085,232101,114140,117961,232101,201733,11339,11833,,0.869160409,0.048853732,0.050982116,,,
Lawrence County,Ohio,39,087,39087,57385,28127,29258,57385,53954,961,616,,0.940210856,0.016746537,0.010734513,,,
Licking County,Ohio,39,089,39089,180311,89196,91115,180311,156892,7231,4223,,0.87011885,0.040102933,0.023420645,,,
Logan County,Ohio,39,091,39091,46140,23206,22934,46140,42751,796,1044,,0.926549632,0.017251842,0.022626788,,,
Lorain County,Ohio,39,093,39093,314588,155867,158721,314588,250254,23588,33992,,0.795497603,0.07498061,0.108052437,,,
Lucas County,Ohio,39,095,39095,428748,208323,220425,428748,296678,83542,32860,,0.691963578,0.194851055,0.076641757,,,
Madison County,Ohio,39,097,39097,44126,24262,19864,44126,38614,2080,1300,,0.875084984,0.047137742,0.029461089,,,
Mahoning County,Ohio,39,099,39099,227063,111366,115697,227063,172628,32405,14765,,0.760264772,0.142713696,0.065026006,,,
Marion County,Ohio,39,101,39101,65145,35012,30133,65145,57079,3395,2034,,0.876183897,0.052114514,0.031222657,,,
Medina County,Ohio,39,103,39103,183049,91007,92042,183049,169696,2368,4803,,0.927052319,0.012936427,0.026238876,,,
Meigs County,Ohio,39,105,39105,22072,11017,11055,22072,21331,132,199,,0.966428054,0.005980428,0.009015948,,,
Mercer County,Ohio,39,107,39107,42438,21501,20937,42438,40308,298,922,,0.949809133,0.007022009,0.021725812,,,
Miami County,Ohio,39,109,39109,109549,54495,55054,109549,99899,2261,2294,,0.911911565,0.020639166,0.020940401,,,
Monroe County,Ohio,39,111,39111,13308,6812,6496,13308,12700,70,24,,0.954313195,0.005259994,0.001803427,,,
Montgomery County,Ohio,39,113,39113,535528,259362,276166,535528,370565,109697,21691,,0.691961952,0.204838963,0.040503951,,,
Morgan County,Ohio,39,115,39115,13758,6911,6847,13758,12551,417,146,,0.912269225,0.030309638,0.010612008,,,
Morrow County,Ohio,39,117,39117,35214,17792,17422,35214,33470,188,641,,0.950474243,0.005338786,0.018202987,,,
Muskingum County,Ohio,39,119,39119,86382,42085,44297,86382,78566,2721,1111,,0.909518187,0.031499618,0.012861476,,,
Noble County,Ohio,39,121,39121,14252,8663,5589,14252,13341,572,181,,0.936079147,0.040134718,0.012699972,,,
Ottawa County,Ohio,39,123,39123,40161,20112,20049,40161,37241,448,2093,,0.927292647,0.011155101,0.052115236,,,
Paulding County,Ohio,39,125,39125,18800,9449,9351,18800,17336,149,1043,,0.92212766,0.007925532,0.055478723,,,
Perry County,Ohio,39,127,39127,35474,17781,17693,35474,34080,80,288,,0.960703614,0.002255173,0.008118622,,,
Pickaway County,Ohio,39,129,39129,59407,31203,28204,59407,54636,1778,1046,,0.919689599,0.029929133,0.017607353,,,
Pike County,Ohio,39,131,39131,27080,13503,13577,27080,25774,289,164,,0.951772526,0.010672083,0.00605613,,,
Portage County,Ohio,39,133,39133,161421,79586,81835,161421,141303,7621,3591,,0.875369376,0.047211949,0.022246176,,,
Preble County,Ohio,39,135,39135,40802,20317,20485,40802,39063,321,441,,0.95737954,0.007867261,0.010808294,,,
Putnam County,Ohio,39,137,39137,34352,17288,17064,34352,31620,294,2264,,0.920470424,0.008558454,0.065905915,,,
Richland County,Ohio,39,139,39139,125138,63994,61144,125138,106341,9316,2757,,0.849789832,0.074445812,0.022031677,,,
Ross County,Ohio,39,141,39141,76748,40007,36741,76748,68353,4131,1070,,0.890616042,0.053825507,0.013941731,,,
Sandusky County,Ohio,39,143,39143,58770,29258,29512,58770,50347,1894,6247,,0.856678578,0.032227327,0.106295729,,,
Scioto County,Ohio,39,145,39145,73118,36234,36884,73118,68092,1786,1093,,0.931261796,0.02442627,0.01494844,,,
Seneca County,Ohio,39,147,39147,54861,27655,27206,54861,49641,1479,3031,,0.90485044,0.026959042,0.055248719,,,
Shelby County,Ohio,39,149,39149,48007,24304,23703,48007,44523,1031,807,,0.92742725,0.021476035,0.016810049,,,
Stark County,Ohio,39,151,39151,373764,182836,190928,373764,318786,28074,10887,,0.852907182,0.075111568,0.029128006,,,
Summit County,Ohio,39,153,39153,538087,262128,275959,538087,403547,75307,13884,,0.749966084,0.139953205,0.025802519,,,
Trumbull County,Ohio,39,155,39155,201367,98837,102530,201367,173084,16140,4382,,0.85954501,0.08015216,0.021761262,,,
Tuscarawas County,Ohio,39,157,39157,92585,46450,46135,92585,87374,689,4070,,0.943716585,0.00744181,0.043959605,,,
Union County,Ohio,39,159,39159,65293,31579,33714,65293,56522,1568,1905,,0.86566707,0.024014825,0.029176175,,,
Van Wert County,Ohio,39,161,39161,28824,14360,14464,28824,27073,199,1138,,0.939252012,0.006903969,0.039480988,,,
Vinton County,Ohio,39,163,39163,12686,6371,6315,12686,12200,76,11,,0.961690052,0.005990856,0.000867098,,,
Warren County,Ohio,39,165,39165,246364,124782,121582,246364,206234,8330,8187,,0.837110942,0.033811758,0.033231316,,,
Washington County,Ohio,39,167,39167,59318,29620,29698,59318,55969,692,720,,0.943541589,0.011665936,0.012137968,,,
Wayne County,Ohio,39,169,39169,116618,58136,58482,116618,108708,1351,2781,,0.932171706,0.011584833,0.023847091,,,
Williams County,Ohio,39,171,39171,36862,18388,18474,36862,34057,419,1934,,0.923905377,0.011366719,0.052465954,,,
Wood County,Ohio,39,173,39173,131795,65293,66502,131795,115868,2615,8425,,0.87915323,0.01984142,0.063925035,,,
Wyandot County,Ohio,39,175,39175,21699,10705,10994,21699,20623,46,665,,0.950412461,0.002119913,0.030646574,,,
Adair County,Oklahoma,40,001,40001,19595,9818,9777,19595,7916,62,1328,,0.403980607,0.003164072,0.067772391,,,
Alfalfa County,Oklahoma,40,003,40003,5685,3592,2093,5685,4704,194,332,,0.827440633,0.03412489,0.058399296,,,
Atoka County,Oklahoma,40,005,40005,14255,7888,6367,14255,9864,555,605,,0.691967731,0.038933707,0.042441249,,,
Beaver County,Oklahoma,40,007,40007,5041,2499,2542,5041,3561,14,1381,,0.706407459,0.002777227,0.273953581,,,
Beckham County,Oklahoma,40,009,40009,22202,12515,9687,22202,18368,1193,2912,,0.827312855,0.053733898,0.131159355,,,
Blaine County,Oklahoma,40,011,40011,8603,4530,4073,8603,6487,373,1012,,0.754039289,0.043356968,0.117633384,,,
Bryan County,Oklahoma,40,013,40013,47237,23115,24122,47237,33243,1122,3612,,0.70374918,0.023752567,0.076465483,,,
Caddo County,Oklahoma,40,015,40015,26626,15027,11599,26626,15550,969,4369,,0.584015624,0.036392999,0.164087734,,,
Canadian County,Oklahoma,40,017,40017,162621,80773,81848,162621,121172,5897,18557,,0.745119019,0.036262229,0.114111954,,,
Carter County,Oklahoma,40,019,40019,48255,23526,24729,48255,33486,2869,3950,,0.693938452,0.059454979,0.081856802,,,
Cherokee County,Oklahoma,40,021,40021,47621,23289,24332,47621,22312,668,3665,,0.46853279,0.014027425,0.076961845,,,
Choctaw County,Oklahoma,40,023,40023,14299,6900,7399,14299,8501,1352,681,,0.594517099,0.094552067,0.047625708,,,
Cimarron County,Oklahoma,40,025,40025,2247,1132,1115,2247,1809,2,557,,0.805073431,0.000890076,0.24788607,,,
Cleveland County,Oklahoma,40,027,40027,297545,148524,149021,297545,212056,14585,31631,,0.712685476,0.049017796,0.106306609,,,
Coal County,Oklahoma,40,029,40029,5275,2679,2596,5275,3514,13,232,,0.666161137,0.002464455,0.043981043,,,
Comanche County,Oklahoma,40,031,40031,121699,62938,58761,121699,71444,18640,17481,,0.587054947,0.153164775,0.143641279,,,
Cotton County,Oklahoma,40,033,40033,5475,2636,2839,5475,4312,90,407,,0.787579909,0.016438356,0.0743379,,,
Craig County,Oklahoma,40,035,40035,14215,7321,6894,14215,8879,494,516,,0.624621878,0.034752023,0.036299683,,,
Creek County,Oklahoma,40,037,40037,72353,35915,36438,72353,55050,1544,3706,,0.76085304,0.02133982,0.051221097,,,
Custer County,Oklahoma,40,039,40039,28332,13973,14359,28332,20107,826,5530,,0.709692221,0.029154313,0.195185656,,,
Delaware County,Oklahoma,40,041,40041,41017,20309,20708,41017,26060,186,1774,,0.63534632,0.004534705,0.04325036,,,
Dewey County,Oklahoma,40,043,40043,4433,2201,2232,4433,3699,2,267,,0.834423641,0.000451162,0.060230092,,,
Ellis County,Oklahoma,40,045,40045,3717,1820,1897,3717,3256,9,330,,0.875975249,0.002421308,0.088781275,,,
Garfield County,Oklahoma,40,047,40047,62322,31274,31048,62322,46543,1267,9234,,0.746814929,0.0203299,0.148165977,,,
Garvin County,Oklahoma,40,049,40049,25779,12806,12973,25779,20194,405,2575,,0.783350789,0.015710462,0.099887505,,,
Grady County,Oklahoma,40,051,40051,55868,28043,27825,55868,45551,1203,3785,,0.81533257,0.021532899,0.06774898,,,
Grant County,Oklahoma,40,053,40053,4137,2088,2049,4137,3661,88,191,,0.884940778,0.021271453,0.046168721,,,
Greer County,Oklahoma,40,055,40055,5498,3123,2375,5498,4428,371,703,,0.805383776,0.067479083,0.127864678,,,
Harmon County,Oklahoma,40,057,40057,2452,1237,1215,2452,1669,273,773,,0.680668842,0.111337684,0.315252855,,,
Harper County,Oklahoma,40,059,40059,3231,1599,1632,3231,2471,2,753,,0.764778706,0.000619003,0.233054782,,,
Haskell County,Oklahoma,40,061,40061,11667,5792,5875,11667,8090,32,592,,0.69340876,0.002742779,0.050741407,,,
Hughes County,Oklahoma,40,063,40063,13411,7419,5992,13411,8653,626,817,,0.645216613,0.0466781,0.06092014,,,
Jackson County,Oklahoma,40,065,40065,24730,12471,12259,24730,17809,1637,6075,,0.720137485,0.066194905,0.245653053,,,
Jefferson County,Oklahoma,40,067,40067,5377,2650,2727,5377,4286,77,579,,0.797098754,0.014320253,0.107680863,,,
Johnston County,Oklahoma,40,069,40069,10334,5224,5110,10334,7110,248,623,,0.688020128,0.023998452,0.060286433,,,
Kay County,Oklahoma,40,071,40071,43731,21868,21863,43731,32525,943,3833,,0.743751572,0.02156365,0.087649493,,,
Kingfisher County,Oklahoma,40,073,40073,15288,7616,7672,15288,12423,174,2746,,0.812598116,0.011381476,0.179618001,,,
Kiowa County,Oklahoma,40,075,40075,8458,4058,4400,8458,6858,284,999,,0.810829983,0.033577678,0.118113029,,,
Latimer County,Oklahoma,40,077,40077,9495,4813,4682,9495,5977,124,375,,0.629489205,0.013059505,0.039494471,,,
Le Flore County,Oklahoma,40,079,40079,48728,24583,24145,48728,34574,900,3782,,0.709530455,0.018469874,0.077614513,,,
Lincoln County,Oklahoma,40,081,40081,33917,17001,16916,33917,27899,590,1278,,0.822566854,0.017395406,0.037680219,,,
Logan County,Oklahoma,40,083,40083,50905,25442,25463,50905,39723,3301,4376,,0.78033592,0.064846282,0.085964051,,,
Love County,Oklahoma,40,085,40085,10196,5122,5074,10196,7374,217,1785,,0.723224794,0.021282856,0.175068654,,,
McClain County,Oklahoma,40,087,40087,43779,21864,21915,43779,34797,460,4086,,0.794833139,0.010507321,0.09333242,,,
McCurtain County,Oklahoma,40,089,40089,30825,15219,15606,30825,18731,2384,2046,,0.607656123,0.077339822,0.066374696,,,
McIntosh County,Oklahoma,40,091,40091,19237,9481,9756,19237,13091,538,581,,0.680511514,0.027966939,0.030202214,,,
Major County,Oklahoma,40,093,40093,7656,3828,3828,7656,6468,2,808,,0.844827586,0.000261233,0.10553814,,,
Marshall County,Oklahoma,40,095,40095,15628,7960,7668,15628,10502,138,2743,,0.671998976,0.008830305,0.1755183,,,
Mayes County,Oklahoma,40,097,40097,39406,19763,19643,39406,25127,162,1495,,0.637644014,0.004111049,0.037938385,,,
Murray County,Oklahoma,40,099,40099,13807,7051,6756,13807,9884,176,965,,0.715868762,0.012747157,0.069892084,,,
Muskogee County,Oklahoma,40,101,40101,66471,32650,33821,66471,37153,6490,4814,,0.558935476,0.097636563,0.07242256,,,
Noble County,Oklahoma,40,103,40103,10909,5407,5502,10909,8787,133,475,,0.805481712,0.012191768,0.04354203,,,
Nowata County,Oklahoma,40,105,40105,9392,4629,4763,9392,6192,153,282,,0.659284497,0.01629046,0.030025554,,,
Okfuskee County,Oklahoma,40,107,40107,11304,6141,5163,11304,6986,743,402,,0.618011323,0.065728946,0.035562633,,,
Oklahoma County,Oklahoma,40,109,40109,800487,393285,407202,800487,479766,116150,157068,,0.59934265,0.145099171,0.196215554,,,
Okmulgee County,Oklahoma,40,111,40111,36922,18350,18572,36922,23272,2605,1838,,0.630301717,0.070554141,0.049780619,,,
Osage County,Oklahoma,40,113,40113,45963,23200,22763,45963,29109,4676,2051,,0.633313752,0.101734003,0.044622849,,,
Ottawa County,Oklahoma,40,115,40115,30360,14958,15402,30360,19385,335,1792,,0.638504611,0.011034256,0.059025033,,,
Pawnee County,Oklahoma,40,117,40117,15689,7889,7800,15689,11984,151,558,,0.763847282,0.009624578,0.03556632,,,
Payne County,Oklahoma,40,119,40119,82290,42085,40205,82290,62628,3042,5287,,0.761064528,0.036966825,0.06424839,,,
Pittsburg County,Oklahoma,40,121,40121,43629,22196,21433,43629,30653,1013,2431,,0.702583144,0.023218501,0.055719819,,,
Pontotoc County,Oklahoma,40,123,40123,38158,18666,19492,38158,24835,957,2401,,0.65084648,0.025079931,0.062922585,,,
Pottawatomie County,Oklahoma,40,125,40125,73011,35093,37918,73011,52814,2305,4501,,0.723370451,0.031570585,0.061648245,,,
Pushmataha County,Oklahoma,40,127,40127,10787,5281,5506,10787,7552,154,434,,0.700101975,0.014276444,0.040233615,,,
Roger Mills County,Oklahoma,40,129,40129,3378,1698,1680,3378,2814,3,282,,0.8330373,0.000888099,0.08348135,,,
Rogers County,Oklahoma,40,131,40131,97235,48720,48515,97235,69508,954,5690,,0.714845477,0.009811282,0.058518023,,,
Seminole County,Oklahoma,40,133,40133,23550,11598,11952,23550,15245,1016,1262,,0.647346072,0.043142251,0.05358811,,,
Sequoyah County,Oklahoma,40,135,40135,39676,19664,20012,39676,24755,817,1925,,0.623928823,0.020591794,0.048517996,,,
Stephens County,Oklahoma,40,137,40137,43314,21195,22119,43314,34901,675,3649,,0.805767188,0.015583876,0.084245279,,,
Texas County,Oklahoma,40,139,40139,20880,10944,9936,20880,10686,868,10679,,0.511781609,0.041570881,0.51144636,,,
Tillman County,Oklahoma,40,141,40141,6967,3412,3555,6967,4524,529,1927,,0.649346921,0.075929381,0.276589637,,,
Tulsa County,Oklahoma,40,143,40143,673708,330663,343045,673708,422034,65542,102464,,0.626434598,0.097285471,0.152089629,,,
Wagoner County,Oklahoma,40,145,40145,84339,42042,42297,84339,58751,2876,6937,,0.696605366,0.034100475,0.08225139,,,
Washington County,Oklahoma,40,147,40147,52895,26073,26822,52895,38525,1448,3538,,0.72832971,0.027374988,0.066887229,,,
Washita County,Oklahoma,40,149,40149,10857,5425,5432,10857,9355,154,1021,,0.861656074,0.014184397,0.094040711,,,
Woods County,Oklahoma,40,151,40151,8619,4586,4033,8619,7547,218,635,,0.875623622,0.025292957,0.07367444,,,
Woodward County,Oklahoma,40,153,40153,20260,10521,9739,20260,16924,248,3021,,0.835340573,0.012240869,0.14911155,,,
Baker County,Oregon,41,001,41001,16796,8799,7997,16796,15199,206,842,,0.904917838,0.012264825,0.050130984,,,
Benton County,Oregon,41,003,41003,96359,48383,47976,96359,77495,1346,8751,,0.80423209,0.013968597,0.090816634,,,
Clackamas County,Oregon,41,005,41005,422308,209562,212746,422308,338903,4448,41314,,0.802501965,0.010532597,0.097829073,,,
Clatsop County,Oregon,41,007,41007,41343,20649,20694,41343,35338,390,4020,,0.854751711,0.009433278,0.097235324,,,
Columbia County,Oregon,41,009,41009,53178,27014,26164,53178,46262,301,3388,,0.869946218,0.005660235,0.063710557,,,
Coos County,Oregon,41,011,41011,64832,32050,32782,64832,55520,366,4540,,0.856367226,0.00564536,0.070027147,,,
Crook County,Oregon,41,013,41013,25651,12743,12908,25651,22895,65,1961,,0.892557795,0.002534014,0.076449261,,,
Curry County,Oregon,41,015,41015,23463,11474,11989,23463,20241,60,1769,,0.862677407,0.002557218,0.075395303,,,
Deschutes County,Oregon,41,017,41017,203026,101112,101914,203026,179623,833,18140,,0.884729049,0.004102923,0.089348162,,,
Douglas County,Oregon,41,019,41019,111807,55664,56143,111807,97979,396,7133,,0.876322592,0.003541818,0.063797437,,,
Gilliam County,Oregon,41,021,41021,2002,1070,932,2002,1683,0,174,,0.840659341,0,0.086913087,,,
Grant County,Oregon,41,023,41023,7238,3674,3564,7238,6475,8,306,,0.894584139,0.001105278,0.042276872,,,
Harney County,Oregon,41,025,41025,7515,3806,3709,7515,6596,16,412,,0.877711244,0.002129075,0.054823686,,,
Hood River County,Oregon,41,027,41027,23958,11962,11996,23958,17635,227,7260,,0.736079806,0.009474914,0.303030303,,,
Jackson County,Oregon,41,029,41029,222563,109264,113299,222563,184577,1475,31625,,0.829324731,0.006627337,0.142094598,,,
Jefferson County,Oregon,41,031,41031,24973,12692,12281,24973,15666,176,5236,,0.627317503,0.007047611,0.20966644,,,
Josephine County,Oregon,41,033,41033,88069,42852,45217,88069,76884,487,7434,,0.872997309,0.005529755,0.084411087,,,
Klamath County,Oregon,41,035,41035,69812,35126,34686,69812,55581,493,9387,,0.796152524,0.007061823,0.134461124,,,
Lake County,Oregon,41,037,41037,8254,4454,3800,8254,7137,43,853,,0.864671674,0.005209595,0.103343833,,,
Lane County,Oregon,41,039,41039,382628,189067,193561,382628,313849,4472,39044,,0.820245774,0.011687592,0.10204167,,,
Lincoln County,Oregon,41,041,41041,50632,24412,26220,50632,41749,155,5036,,0.824557592,0.003061305,0.09946279,,,
Linn County,Oregon,41,043,41043,129794,64816,64978,129794,110760,526,13343,,0.853352235,0.004052576,0.102801362,,,
Malheur County,Oregon,41,045,41045,31701,17383,14318,31701,23346,332,10628,,0.736443645,0.010472856,0.335257563,,,
Marion County,Oregon,41,047,41047,346532,173657,172875,346532,239703,3900,98133,,0.691719668,0.011254372,0.283185968,,,
Morrow County,Oregon,41,049,41049,12249,6250,5999,12249,7882,123,5050,,0.6434811,0.010041636,0.412278553,,,
Multnomah County,Oregon,41,051,41051,803863,400239,403624,803863,562458,44401,105204,,0.699693853,0.055234536,0.130873047,,,
Polk County,Oregon,41,053,41053,88553,43576,44977,88553,70700,669,13459,,0.798391923,0.007554798,0.151988075,,,
Sherman County,Oregon,41,055,41055,1908,959,949,1908,1654,7,92,,0.86687631,0.003668763,0.048218029,,,
Tillamook County,Oregon,41,057,41057,27471,13894,13577,27471,23979,163,3024,,0.872884132,0.00593353,0.11007972,,,
Umatilla County,Oregon,41,059,41059,80087,41965,38122,80087,56749,594,23185,,0.708591906,0.007416934,0.289497671,,,
Union County,Oregon,41,061,41061,26192,12959,13233,26192,23146,235,1400,,0.883704948,0.008972205,0.053451436,,,
Wallowa County,Oregon,41,063,41063,7532,3695,3837,7532,6779,92,298,,0.900026553,0.012214551,0.039564525,,,
Wasco County,Oregon,41,065,41065,26603,13504,13099,26603,21177,114,5260,,0.796038041,0.004285231,0.197722061,,,
Washington County,Oregon,41,067,41067,600266,299739,300527,600266,396022,13763,109211,,0.65974418,0.022928169,0.181937674,,,
Wheeler County,Oregon,41,069,41069,1434,680,754,1434,1233,0,65,,0.859832636,0,0.045327755,,,
Yamhill County,Oregon,41,071,41071,108122,54704,53418,108122,84781,760,18490,,0.78412349,0.007029097,0.171010525,,,
Adams County,Pennsylvania,42,001,42001,105183,52268,52915,105183,94864,1999,7919,,0.901894793,0.019004972,0.075287832,,,
Allegheny County,Pennsylvania,42,003,42003,1240476,604817,635659,1240476,953922,155056,34884,,0.76899674,0.124997179,0.028121463,,,
Armstrong County,Pennsylvania,42,005,42005,65069,32653,32416,65069,62318,627,580,,0.957721803,0.009635925,0.008913615,,,
Beaver County,Pennsylvania,42,007,42007,166993,82004,84989,166993,146436,10355,3781,,0.876899032,0.062008587,0.022641668,,,
Bedford County,Pennsylvania,42,009,42009,47503,23683,23820,47503,45625,372,567,,0.960465655,0.007831084,0.011936088,,,
Berks County,Pennsylvania,42,011,42011,429989,213223,216766,429989,310830,20358,103077,,0.722878957,0.047345397,0.239720086,,,
Blair County,Pennsylvania,42,013,42013,121854,60176,61678,121854,113639,2165,1781,,0.932583255,0.017767164,0.014615852,,,
Bradford County,Pennsylvania,42,015,42015,59971,29957,30014,59971,57047,577,942,,0.951243101,0.009621317,0.015707592,,,
Bucks County,Pennsylvania,42,017,42017,645993,319358,326635,645993,532197,24211,40952,,0.823843292,0.037478734,0.063393876,,,
Butler County,Pennsylvania,42,019,42019,195870,97667,98203,195870,183784,2032,3799,,0.938295808,0.010374228,0.019395517,,,
Cambria County,Pennsylvania,42,021,42021,132355,65912,66443,132355,121267,4301,2646,,0.916225303,0.032495939,0.019991689,,,
Cameron County,Pennsylvania,42,023,42023,4475,2213,2262,4475,4213,2,83,,0.941452514,0.000446927,0.018547486,,,
Carbon County,Pennsylvania,42,025,42025,65191,32706,32485,65191,58673,1518,4154,,0.900016873,0.023285423,0.063720452,,,
Centre County,Pennsylvania,42,027,42027,158041,83195,74846,158041,134114,5265,5630,,0.848602578,0.03331414,0.035623667,,,
Chester County,Pennsylvania,42,029,42029,540896,268207,272689,540896,423956,28466,44329,,0.783803171,0.052627492,0.081954757,,,
Clarion County,Pennsylvania,42,031,42031,37297,18432,18865,37297,35371,670,414,,0.948360458,0.017963911,0.011100088,,,
Clearfield County,Pennsylvania,42,033,42033,78902,41439,37463,78902,73484,1752,2271,,0.931332539,0.02220476,0.02878254,,,
Clinton County,Pennsylvania,42,035,42035,37707,18897,18810,37707,35619,524,690,,0.944625666,0.013896624,0.01829899,,,
Columbia County,Pennsylvania,42,037,42037,65055,31475,33580,65055,60095,1254,2393,,0.923756821,0.019275997,0.036784259,,,
Crawford County,Pennsylvania,42,039,42039,83189,40912,42277,83189,77989,1383,1269,,0.937491736,0.016624794,0.015254421,,,
Cumberland County,Pennsylvania,42,041,42041,264422,131752,132670,264422,220547,11848,12913,,0.834072051,0.044807164,0.048834817,,,
Dauphin County,Pennsylvania,42,043,42043,287484,140412,147072,287484,186536,50766,32425,,0.64885698,0.176587219,0.112788886,,,
Delaware County,Pennsylvania,42,045,42045,576195,279070,297125,576195,371394,126895,27733,,0.644563039,0.220229263,0.048131275,,,
Elk County,Pennsylvania,42,047,42047,30703,15638,15065,30703,29211,257,306,,0.9514054,0.008370518,0.009966453,,,
Erie County,Pennsylvania,42,049,42049,269544,133911,135633,269544,225040,18596,12487,,0.83489152,0.068990592,0.046326388,,,
Fayette County,Pennsylvania,42,051,42051,126967,63575,63392,126967,114397,5156,1707,,0.900997897,0.040608977,0.013444438,,,
Forest County,Pennsylvania,42,053,42053,6785,4815,1970,6785,5362,949,338,,0.79027266,0.139867354,0.04981577,,,
Franklin County,Pennsylvania,42,055,42055,156626,77534,79092,156626,137549,5056,11218,,0.878200299,0.03228072,0.071622847,,,
Fulton County,Pennsylvania,42,057,42057,14545,7469,7076,14545,13693,198,181,,0.941423169,0.013612925,0.012444139,,,
Greene County,Pennsylvania,42,059,42059,35265,18475,16790,35265,32556,941,546,,0.923181625,0.026683681,0.015482773,,,
Huntingdon County,Pennsylvania,42,061,42061,43844,23346,20498,43844,39561,2152,885,,0.902312745,0.049083113,0.020185202,,,
Indiana County,Pennsylvania,42,063,42063,83213,41460,41753,83213,77087,2041,1482,,0.926381695,0.024527418,0.017809717,,,
Jefferson County,Pennsylvania,42,065,42065,44099,22072,22027,44099,42575,207,433,,0.965441393,0.004693984,0.009818817,,,
Juniata County,Pennsylvania,42,067,42067,23419,11743,11676,23419,21825,246,932,,0.931935608,0.010504291,0.039796746,,,
Lackawanna County,Pennsylvania,42,069,42069,215834,105991,109843,215834,180058,6635,19782,,0.834242983,0.030741218,0.091653771,,,
Lancaster County,Pennsylvania,42,071,42071,555151,273012,282139,555151,460035,22176,62574,,0.828666435,0.039945889,0.112715279,,,
Lawrence County,Pennsylvania,42,073,42073,85423,41598,43825,85423,77191,3164,1756,,0.903632511,0.037039205,0.020556525,,,
Lebanon County,Pennsylvania,42,075,42075,143592,70905,72687,143592,117746,2950,21113,,0.8200039,0.02054432,0.147034654,,,
Lehigh County,Pennsylvania,42,077,42077,375408,184859,190549,375408,250651,26043,101194,,0.667676235,0.069372523,0.269557388,,,
Luzerne County,Pennsylvania,42,079,42079,325978,162357,163621,325978,255267,17107,51917,,0.783080453,0.052479002,0.159265349,,,
Lycoming County,Pennsylvania,42,081,42081,113570,55927,57643,113570,101203,5038,2562,,0.891106806,0.044360306,0.022558774,,,
McKean County,Pennsylvania,42,083,42083,40149,20749,19400,40149,37614,927,731,,0.936860196,0.023088993,0.018207178,,,
Mercer County,Pennsylvania,42,085,42085,109852,54465,55387,109852,97737,6123,1751,,0.889715253,0.05573863,0.015939628,,,
Mifflin County,Pennsylvania,42,087,42087,46074,22611,23463,46074,43274,329,1001,,0.939228198,0.007140687,0.021725919,,,
Monroe County,Pennsylvania,42,089,42089,167784,83976,83808,167784,111592,23488,29702,,0.665093215,0.13998951,0.177025223,,,
Montgomery County,Pennsylvania,42,091,42091,861225,421910,439315,861225,640759,79804,55791,,0.744008825,0.092663357,0.064780981,,,
Montour County,Pennsylvania,42,093,42093,18079,8862,9217,18079,16357,444,531,,0.904751369,0.02455888,0.029371094,,,
Northampton County,Pennsylvania,42,095,42095,315927,156368,159559,315927,242420,18651,47075,,0.767329161,0.05903579,0.149005941,,,
Northumberland County,Pennsylvania,42,097,42097,90925,46275,44650,90925,82792,2468,4412,,0.910552653,0.02714325,0.048523508,,,
Perry County,Pennsylvania,42,099,42099,45988,23261,22727,45988,43438,368,1045,,0.944550752,0.008002088,0.022723319,,,
Philadelphia County,Pennsylvania,42,101,42101,1582432,749410,833022,1582432,571785,631361,240543,,0.361333062,0.398981441,0.152008428,,,
Pike County,Pennsylvania,42,103,42103,59691,30399,29292,59691,48000,3967,7177,,0.804141328,0.06645893,0.120235881,,,
Potter County,Pennsylvania,42,105,42105,16276,8148,8128,16276,15572,71,272,,0.956746129,0.004362251,0.016711723,,,
Schuylkill County,Pennsylvania,42,107,42107,143259,73971,69288,143259,128550,4152,9744,,0.897325822,0.028982472,0.068016669,,,
Snyder County,Pennsylvania,42,109,42109,39711,19893,19818,39711,37723,313,990,,0.949938304,0.007881947,0.02493012,,,
Somerset County,Pennsylvania,42,111,42111,73255,38394,34861,73255,69242,1418,1096,,0.945218756,0.01935704,0.014961436,,,
Sullivan County,Pennsylvania,42,113,42113,5849,3052,2797,5849,5534,132,117,,0.94614464,0.02256796,0.020003419,,,
Susquehanna County,Pennsylvania,42,115,42115,38349,19378,18971,38349,36699,90,875,,0.956974106,0.002346867,0.022816762,,,
Tioga County,Pennsylvania,42,117,42117,41078,20629,20449,41078,39441,351,670,,0.960148985,0.00854472,0.016310434,,,
Union County,Pennsylvania,42,119,42119,42570,22925,19645,42570,37935,2575,2093,,0.891120507,0.060488607,0.049166079,,,
Venango County,Pennsylvania,42,121,42121,50096,24948,25148,50096,47208,576,587,,0.942350687,0.011497924,0.011717502,,,
Warren County,Pennsylvania,42,123,42123,38174,19224,18950,38174,36346,323,453,,0.952114004,0.008461256,0.011866716,,,
Washington County,Pennsylvania,42,125,42125,209778,103709,106069,209778,190444,6679,4115,,0.907835903,0.03183842,0.019615975,,,
Wayne County,Pennsylvania,42,127,42127,51189,27355,23834,51189,46100,1618,2528,,0.90058411,0.031608353,0.04938561,,,
Westmoreland County,Pennsylvania,42,129,42129,353345,174499,178846,353345,327086,8858,5402,,0.925684529,0.025068984,0.015288174,,,
Wyoming County,Pennsylvania,42,131,42131,26075,13132,12943,26075,24649,210,612,,0.945311601,0.008053691,0.023470757,,,
York County,Pennsylvania,42,133,42133,459312,228254,231058,459312,380861,27012,41774,,0.829198889,0.058809698,0.090949072,,,
Bristol County,Rhode Island,44,001,44001,50568,24505,26063,50568,45701,539,2043,,0.903753362,0.010658915,0.040401044,,,
Kent County,Rhode Island,44,003,44003,170658,83405,87253,170658,147797,3513,10976,,0.866042026,0.02058503,0.064315766,,,
Newport County,Rhode Island,44,005,44005,85095,42040,43055,85095,72217,3236,5583,,0.848663259,0.038028086,0.065609025,,,
Providence County,Rhode Island,44,007,44007,658977,323751,335226,658977,409072,54845,164093,,0.620768251,0.083227487,0.249011726,,,
Washington County,Rhode Island,44,009,44009,130073,63472,66601,130073,117574,1729,4808,,0.903907806,0.013292536,0.036963859,,,
Abbeville County,South Carolina,45,001,45001,24352,12013,12339,24352,16882,6287,475,,0.693249014,0.258171813,0.019505585,,,
Aiken County,South Carolina,45,003,45003,171949,83254,88695,171949,113667,42183,11974,,0.66105066,0.245322741,0.069636927,,,
Allendale County,South Carolina,45,005,45005,7738,4147,3591,7738,1871,4951,799,,0.241793745,0.639829413,0.103256655,,,
Anderson County,South Carolina,45,007,45007,207218,100250,106968,207218,159966,28250,10188,,0.771969617,0.136329856,0.049165613,,,
Bamberg County,South Carolina,45,009,45009,13164,6220,6944,13164,4979,7880,223,,0.378228502,0.598602249,0.01694014,,,
Barnwell County,South Carolina,45,011,45011,20565,9956,10609,20565,10732,8897,576,,0.521857525,0.432628252,0.028008753,,,
Beaufort County,South Carolina,45,013,45013,192123,95249,96874,192123,134712,30354,23539,,0.701175809,0.157992536,0.122520469,,,
Berkeley County,South Carolina,45,015,45015,238723,118933,119790,238723,150619,55308,21150,,0.630936273,0.231682745,0.088596407,,,
Calhoun County,South Carolina,45,017,45017,14150,6932,7218,14150,7813,5463,539,,0.552155477,0.386077739,0.038091873,,,
Charleston County,South Carolina,45,019,45019,414711,201090,213621,414711,274352,98520,29019,,0.66154985,0.237563026,0.06997403,,,
Cherokee County,South Carolina,45,021,45021,56299,27600,28699,56299,40077,10659,2944,,0.711859891,0.189328407,0.052292225,,,
Chester County,South Carolina,45,023,45023,32177,15588,16589,32177,18749,11596,877,,0.582683283,0.360381639,0.027255493,,,
Chesterfield County,South Carolina,45,025,45025,43575,21315,22260,43575,26791,13374,2328,,0.614825014,0.306919105,0.053425129,,,
Clarendon County,South Carolina,45,027,45027,31037,15314,15723,31037,15544,14035,945,,0.5008216,0.45220221,0.03044753,,,
Colleton County,South Carolina,45,029,45029,38623,18403,20220,38623,22269,13389,1562,,0.576573544,0.346658727,0.040442224,,,
Darlington County,South Carolina,45,031,45031,62754,29843,32911,62754,34199,25718,1486,,0.544969245,0.409822481,0.023679765,,,
Dillon County,South Carolina,45,033,45033,28031,13259,14772,28031,12707,12807,931,,0.453319539,0.456887018,0.033213228,,,
Dorchester County,South Carolina,45,035,45035,164322,80359,83963,164322,103658,41255,11323,,0.63082241,0.251061939,0.068907389,,,
Edgefield County,South Carolina,45,037,45037,26508,14175,12333,26508,15755,8335,1650,,0.594348876,0.314433379,0.06224536,,,
Fairfield County,South Carolina,45,039,45039,20741,10108,10633,20741,8028,11499,486,,0.387059447,0.554409141,0.02343185,,,
Florence County,South Carolina,45,041,45041,136921,64441,72480,136921,69090,58857,4391,,0.504597542,0.429861015,0.032069588,,,
Georgetown County,South Carolina,45,043,45043,64200,30782,33418,64200,42513,18545,2259,,0.662196262,0.288862928,0.035186916,,,
Greenville County,South Carolina,45,045,45045,537575,261684,275891,537575,366669,90203,60182,,0.68207971,0.167796121,0.111950891,,,
Greenwood County,South Carolina,45,047,45047,69329,32368,36961,69329,43511,21709,4848,,0.627601725,0.313130148,0.069927447,,,
Hampton County,South Carolina,45,049,45049,18555,9832,8723,18555,7496,9751,750,,0.403988143,0.525518728,0.040420372,,,
Horry County,South Carolina,45,051,45051,368937,178735,190202,368937,286993,43726,25961,,0.777891618,0.11851888,0.070367027,,,
Jasper County,South Carolina,45,053,45053,30658,15349,15309,30658,14407,10558,5259,,0.469926284,0.344379933,0.171537608,,,
Kershaw County,South Carolina,45,055,45055,66924,32874,34050,66924,45304,15687,3744,,0.676946985,0.234400215,0.055944056,,,
Lancaster County,South Carolina,45,057,45057,100905,49272,51633,100905,70990,19569,7062,,0.703533026,0.193934889,0.069986621,,,
Laurens County,South Carolina,45,059,45059,67904,33075,34829,67904,45795,15629,4303,,0.674407988,0.230163172,0.063368874,,,
Lee County,South Carolina,45,061,45061,16330,8327,8003,16330,5545,10180,379,,0.339559094,0.623392529,0.023208818,,,
Lexington County,South Carolina,45,063,45063,300370,146619,153751,300370,220420,44926,22831,,0.733828278,0.149568865,0.076009588,,,
McCormick County,South Carolina,45,065,45065,9701,5148,4553,9701,5305,3993,65,,0.54685084,0.411607051,0.00670034,,,
Marion County,South Carolina,45,067,45067,28900,13434,15466,28900,11117,16123,753,,0.38467128,0.557889273,0.026055363,,,
Marlboro County,South Carolina,45,069,45069,26285,13838,12447,26285,10180,12956,701,,0.387293133,0.492904698,0.026669203,,,
Newberry County,South Carolina,45,071,45071,38121,18606,19515,38121,23394,11139,3403,,0.613677501,0.292201149,0.089268382,,,
Oconee County,South Carolina,45,073,45073,79566,39112,40454,79566,67416,5398,4642,,0.847296584,0.067843049,0.058341503,,,
Orangeburg County,South Carolina,45,075,45075,83531,39211,44320,83531,28678,51467,2100,,0.343321641,0.61614251,0.025140367,,,
Pickens County,South Carolina,45,077,45077,132604,66390,66214,132604,112772,8189,6809,,0.850441917,0.061755301,0.051348376,,,
Richland County,South Carolina,45,079,45079,418725,201180,217545,418725,172815,198151,26339,,0.412717177,0.47322467,0.06290286,,,
Saluda County,South Carolina,45,081,45081,18958,9578,9380,18958,11205,4194,3144,,0.591043359,0.221225868,0.165840279,,,
Spartanburg County,South Carolina,45,083,45083,338096,165028,173068,338096,228924,67021,29892,,0.677097629,0.19823068,0.088412759,,,
Sumter County,South Carolina,45,085,45085,104853,50681,54172,104853,47341,48447,4500,,0.451498765,0.462046866,0.042917227,,,
Union County,South Carolina,45,087,45087,26990,12735,14255,26990,17586,7883,520,,0.651574657,0.292071137,0.019266395,,,
Williamsburg County,South Carolina,45,089,45089,30517,14841,15676,30517,9973,19538,718,,0.326801455,0.640233313,0.02352787,,,
York County,South Carolina,45,091,45091,288559,140308,148251,288559,200638,54031,20331,,0.695310145,0.187244203,0.070456995,,,
Aurora County,South Dakota,46,003,46003,2573,1340,1233,2573,2365,27,164,,0.919160513,0.010493587,0.063738826,,,
Beadle County,South Dakota,46,005,46005,19279,9555,9724,19279,13740,208,2772,,0.712692567,0.010788941,0.143783391,,,
Bennett County,South Dakota,46,007,46007,3354,1585,1769,3354,1252,6,156,,0.373285629,0.001788909,0.046511628,,,
Bon Homme County,South Dakota,46,009,46009,7024,4226,2798,7024,6105,132,162,,0.86916287,0.018792711,0.023063781,,,
Brookings County,South Dakota,46,011,46011,34968,17864,17104,34968,31023,417,1504,,0.887182567,0.011925189,0.043010753,,,
Brown County,South Dakota,46,013,46013,38079,18727,19352,38079,32615,171,1687,,0.856508837,0.004490664,0.044302634,,,
Brule County,South Dakota,46,015,46015,5261,2754,2507,5261,4314,76,81,,0.819996198,0.014445923,0.015396312,,,
Buffalo County,South Dakota,46,017,46017,1757,960,797,1757,381,0,58,,0.216846898,0,0.033010814,,,
Butte County,South Dakota,46,019,46019,10538,5263,5275,10538,9399,0,442,,0.891914974,0,0.041943443,,,
Campbell County,South Dakota,46,021,46021,1481,762,719,1481,1388,0,87,,0.937204591,0,0.058744092,,,
Charles Mix County,South Dakota,46,023,46023,9281,4686,4595,9281,5939,12,250,,0.639909493,0.001292964,0.026936753,,,
Clark County,South Dakota,46,025,46025,3876,1976,1900,3876,3559,21,178,,0.918214654,0.005417957,0.045923633,,,
Clay County,South Dakota,46,027,46027,15133,7493,7640,15133,13127,304,488,,0.867442014,0.020088548,0.032247406,,,
Codington County,South Dakota,46,029,46029,28556,14496,14060,28556,26064,292,854,,0.912732876,0.010225522,0.029906149,,,
Corson County,South Dakota,46,031,46031,3859,1905,1954,3859,1162,4,14,,0.301114278,0.001036538,0.003627883,,,
Custer County,South Dakota,46,033,46033,8686,4297,4389,8686,7892,32,251,,0.908588533,0.003684089,0.028897076,,,
Davison County,South Dakota,46,035,46035,19936,9778,10158,19936,17959,111,941,,0.900832665,0.005567817,0.047201043,,,
Day County,South Dakota,46,037,46037,5460,2748,2712,5460,4661,3,145,,0.853663004,0.000549451,0.026556777,,,
Deuel County,South Dakota,46,039,46039,4318,2216,2102,4318,4087,15,139,,0.946503011,0.00347383,0.032190829,,,
Dewey County,South Dakota,46,041,46041,5230,2604,2626,5230,1056,21,79,,0.201912046,0.004015296,0.015105163,,,
Douglas County,South Dakota,46,043,46043,2823,1404,1419,2823,2629,42,68,,0.931278781,0.01487779,0.02408785,,,
Edmunds County,South Dakota,46,045,46045,4033,2077,1956,4033,3831,33,82,,0.949913216,0.008182494,0.020332259,,,
Fall River County,South Dakota,46,047,46047,7179,3546,3633,7179,6104,13,237,,0.850257696,0.001810837,0.033012954,,,
Faulk County,South Dakota,46,049,46049,2137,1056,1081,2137,2068,0,51,,0.967711745,0,0.023865232,,,
Grant County,South Dakota,46,051,46051,7544,3978,3566,7544,6872,44,506,,0.910922587,0.00583245,0.067073171,,,
Gregory County,South Dakota,46,053,46053,3993,2042,1951,3993,3491,40,43,,0.87427999,0.010017531,0.010768845,,,
Haakon County,South Dakota,46,055,46055,1708,816,892,1708,1508,24,1,,0.882903981,0.014051522,0.00058548,,,
Hamlin County,South Dakota,46,057,46057,6288,3234,3054,6288,5837,19,341,,0.928276081,0.003021628,0.05423028,,,
Hand County,South Dakota,46,059,46059,3045,1561,1484,3045,2853,11,57,,0.936945813,0.003612479,0.018719212,,,
Hanson County,South Dakota,46,061,46061,3473,1771,1702,3473,3243,13,43,,0.933774834,0.003743162,0.012381227,,,
Harding County,South Dakota,46,063,46063,1092,602,490,1092,968,18,21,,0.886446886,0.016483516,0.019230769,,,
Hughes County,South Dakota,46,065,46065,17732,8858,8874,17732,14395,4,543,,0.811809159,0.000225581,0.030622603,,,
Hutchinson County,South Dakota,46,067,46067,7393,3653,3740,7393,6774,5,193,,0.916272149,0.000676315,0.026105776,,,
Hyde County,South Dakota,46,069,46069,1305,653,652,1305,1135,0,19,,0.869731801,0,0.014559387,,,
Jackson County,South Dakota,46,071,46071,2826,1325,1501,2826,1023,5,12,,0.361995754,0.001769285,0.004246285,,,
Jerauld County,South Dakota,46,073,46073,1845,897,948,1845,1637,0,140,,0.887262873,0,0.075880759,,,
Jones County,South Dakota,46,075,46075,1030,436,594,1030,854,8,11,,0.829126214,0.00776699,0.010679612,,,
Kingsbury County,South Dakota,46,077,46077,5210,2672,2538,5210,4935,0,142,,0.947216891,0,0.027255278,,,
Lake County,South Dakota,46,079,46079,11052,5807,5245,11052,10175,55,560,,0.920647847,0.004976475,0.050669562,,,
Lawrence County,South Dakota,46,081,46081,26574,13216,13358,26574,24217,137,974,,0.911304282,0.005155415,0.036652367,,,
Lincoln County,South Dakota,46,083,46083,68286,33921,34365,68286,61767,1548,1970,,0.904533872,0.022669361,0.028849252,,,
Lyman County,South Dakota,46,085,46085,3717,1942,1775,3717,2135,0,28,,0.574387947,0,0.007532957,,,
McCook County,South Dakota,46,087,46087,5732,2938,2794,5732,5441,16,196,,0.94923238,0.002791347,0.034193999,,,
McPherson County,South Dakota,46,089,46089,2278,1127,1151,2278,2186,38,28,,0.959613696,0.016681299,0.012291484,,,
Marshall County,South Dakota,46,091,46091,4355,2273,2082,4355,3750,11,266,,0.861079219,0.002525832,0.061079219,,,
Meade County,South Dakota,46,093,46093,30297,15851,14446,30297,26487,594,1418,,0.874244975,0.019605902,0.046803314,,,
Mellette County,South Dakota,46,095,46095,2043,977,1066,2043,645,5,7,,0.315712188,0.002447381,0.003426334,,,
Miner County,South Dakota,46,097,46097,2299,1164,1135,2299,2176,23,41,,0.946498478,0.01000435,0.017833841,,,
Minnehaha County,South Dakota,46,099,46099,200689,102242,98447,200689,162318,13184,12757,,0.808803671,0.065693685,0.063566015,,,
Moody County,South Dakota,46,101,46101,6371,3218,3153,6371,4807,70,343,,0.754512635,0.010987286,0.053837702,,,
Oglala Lakota County,South Dakota,46,102,46102,13587,6620,6967,13587,901,8,232,,0.066313388,0.000588798,0.017075145,,,
Pennington County,South Dakota,46,103,46103,112081,57256,54825,112081,90040,1463,6165,,0.803347579,0.01305306,0.055004863,,,
Perkins County,South Dakota,46,105,46105,3058,1535,1523,3058,2895,0,26,,0.946697188,0,0.008502289,,,
Potter County,South Dakota,46,107,46107,2430,1180,1250,2430,2196,47,0,,0.903703704,0.019341564,0,,,
Roberts County,South Dakota,46,109,46109,10219,5266,4953,10219,5918,34,243,,0.57911733,0.003327136,0.023779235,,,
Sanborn County,South Dakota,46,111,46111,2370,1179,1191,2370,2249,0,100,,0.948945148,0,0.042194093,,,
Spink County,South Dakota,46,115,46115,6283,3118,3165,6283,5945,57,165,,0.946204043,0.009072099,0.02626134,,,
Stanley County,South Dakota,46,117,46117,3012,1669,1343,3012,2740,2,61,,0.909694555,0.000664011,0.020252324,,,
Sully County,South Dakota,46,119,46119,1481,815,666,1481,1370,74,0,,0.925050641,0.049966239,0,,,
Todd County,South Dakota,46,121,46121,9293,4459,4834,9293,755,28,212,,0.081243947,0.003013021,0.02281287,,,
Tripp County,South Dakota,46,123,46123,5607,2865,2742,5607,4523,36,92,,0.806670234,0.006420546,0.016408061,,,
Turner County,South Dakota,46,125,46125,8772,4431,4341,8772,8253,68,285,,0.940834473,0.007751938,0.03248974,,,
Union County,South Dakota,46,127,46127,16916,8644,8272,16916,15293,142,748,,0.904055332,0.008394419,0.044218491,,,
Walworth County,South Dakota,46,129,46129,5298,2690,2608,5298,4220,16,63,,0.796526991,0.003020008,0.01189128,,,
Yankton County,South Dakota,46,135,46135,23379,12186,11193,23379,20731,362,1309,,0.88673596,0.015483981,0.055990419,,,
Ziebach County,South Dakota,46,137,46137,2410,1192,1218,2410,657,0,30,,0.272614108,0,0.012448133,,,
Anderson County,Tennessee,47,001,47001,78175,38319,39856,78175,68537,2641,3000,,0.876712504,0.033783179,0.03837544,,,
Bedford County,Tennessee,47,003,47003,51291,26087,25204,51291,40832,3661,7968,,0.796085083,0.071377045,0.155348892,,,
Benton County,Tennessee,47,005,47005,15948,7825,8123,15948,14754,289,430,,0.925131678,0.018121395,0.026962629,,,
Bledsoe County,Tennessee,47,007,47007,14905,8705,6200,14905,13197,815,495,,0.885407581,0.054679638,0.033210332,,,
Blount County,Tennessee,47,009,47009,137747,67495,70252,137747,124541,3573,6097,,0.904128584,0.025938859,0.044262307,,,
Bradley County,Tennessee,47,011,47011,109743,53624,56119,109743,93195,5670,8827,,0.849211339,0.051666165,0.080433376,,,
Campbell County,Tennessee,47,013,47013,39568,19719,19849,39568,38023,134,576,,0.960953296,0.003386575,0.014557218,,,
Cannon County,Tennessee,47,015,47015,14661,7408,7253,14661,13797,352,428,,0.94106814,0.024009276,0.029193097,,,
Carroll County,Tennessee,47,017,47017,28461,14164,14297,28461,24395,2533,849,,0.857137838,0.088998981,0.029830294,,,
Carter County,Tennessee,47,019,47019,56462,27665,28797,56462,53247,1151,1327,,0.943059049,0.020385392,0.023502533,,,
Cheatham County,Tennessee,47,021,47021,41500,21070,20430,41500,37534,973,1903,,0.904433735,0.023445783,0.045855422,,,
Chester County,Tennessee,47,023,47023,17452,8447,9005,17452,14842,1713,546,,0.85044694,0.098154939,0.031285813,,,
Claiborne County,Tennessee,47,025,47025,32221,15895,16326,32221,30563,237,516,,0.948542876,0.007355451,0.016014401,,,
Clay County,Tennessee,47,027,47027,7621,3657,3964,7621,7199,72,154,,0.944626689,0.009447579,0.020207322,,,
Cocke County,Tennessee,47,029,47029,36503,17779,18724,36503,34142,553,1066,,0.935320385,0.01514944,0.029203079,,,
Coffee County,Tennessee,47,031,47031,58940,29018,29922,58940,51589,2407,3527,,0.875279946,0.04083814,0.059840516,,,
Crockett County,Tennessee,47,033,47033,13937,6825,7112,13937,10245,1493,1560,,0.735093636,0.107124919,0.111932267,,,
Cumberland County,Tennessee,47,035,47035,62529,30641,31888,62529,59368,693,2106,,0.949447456,0.011082858,0.033680372,,,
Davidson County,Tennessee,47,037,47037,709846,343591,366255,709846,404978,178861,96481,,0.570515295,0.251971554,0.135918213,,,
Decatur County,Tennessee,47,039,47039,11499,5793,5706,11499,10530,353,406,,0.915731803,0.030698322,0.035307418,,,
DeKalb County,Tennessee,47,041,47041,20551,10410,10141,20551,18246,377,1551,,0.887840008,0.018344606,0.07547078,,,
Dickson County,Tennessee,47,043,47043,55197,27124,28073,55197,49604,2191,2688,,0.898672029,0.039694186,0.048698299,,,
Dyer County,Tennessee,47,045,47045,36681,17538,19143,36681,28532,5459,1404,,0.777841389,0.148823642,0.038275947,,,
Fayette County,Tennessee,47,047,47047,42653,21244,21409,42653,28407,11500,1542,,0.666002391,0.269617612,0.036152205,,,
Fentress County,Tennessee,47,049,47049,18948,9456,9492,18948,18023,57,374,,0.951182183,0.003008233,0.019738231,,,
Franklin County,Tennessee,47,051,47051,43478,21445,22033,43478,38529,2015,1604,,0.886172317,0.046345278,0.036892221,,,
Gibson County,Tennessee,47,053,47053,50610,24384,26226,50610,38495,7600,1607,,0.760620431,0.150167951,0.031752618,,,
Giles County,Tennessee,47,055,47055,30442,14755,15687,30442,25740,2618,844,,0.845542343,0.085999606,0.027724854,,,
Grainger County,Tennessee,47,057,47057,23929,12106,11823,23929,22978,269,840,,0.960257428,0.01124159,0.035103849,,,
Greene County,Tennessee,47,059,47059,70919,34914,36005,70919,65389,1371,2662,,0.922023717,0.019331914,0.03753578,,,
Grundy County,Tennessee,47,061,47061,13665,6818,6847,13665,12920,59,231,,0.945481156,0.0043176,0.016904501,,,
Hamblen County,Tennessee,47,063,47063,64930,32224,32706,64930,53306,1737,9561,,0.820976436,0.026751887,0.147250886,,,
Hamilton County,Tennessee,47,065,47065,370913,179901,191012,370913,263665,65155,28357,,0.710854028,0.175661139,0.07645189,,,
Hancock County,Tennessee,47,067,47067,6790,3356,3434,6790,6574,30,74,,0.968188513,0.004418262,0.01089838,,,
Hardeman County,Tennessee,47,069,47069,25477,14098,11379,25477,13772,10245,530,,0.540566001,0.402127409,0.020803077,,,
Hardin County,Tennessee,47,071,47071,26939,13006,13933,26939,24924,820,649,,0.925201381,0.03043914,0.024091466,,,
Hawkins County,Tennessee,47,073,47073,57446,28330,29116,57446,54282,694,1058,,0.944922188,0.012080911,0.018417296,,,
Haywood County,Tennessee,47,075,47075,17672,8408,9264,17672,7697,8861,834,,0.435547759,0.501414667,0.0471933,,,
Henderson County,Tennessee,47,077,47077,27906,13679,14227,27906,24498,2125,793,,0.877875726,0.076148499,0.028416828,,,
Henry County,Tennessee,47,079,47079,32345,15754,16591,32345,28274,2335,940,,0.874138198,0.072190447,0.029061679,,,
Hickman County,Tennessee,47,081,47081,25229,13102,12127,25229,22919,911,782,,0.908438701,0.036109239,0.030996076,,,
Houston County,Tennessee,47,083,47083,8293,4144,4149,8293,7715,241,245,,0.930302665,0.029060654,0.029542988,,,
Humphreys County,Tennessee,47,085,47085,19074,9509,9565,19074,17290,370,525,,0.90646954,0.019398134,0.027524379,,,
Jackson County,Tennessee,47,087,47087,11882,6024,5858,11882,11091,55,302,,0.933428716,0.00462885,0.025416597,,,
Jefferson County,Tennessee,47,089,47089,55835,27572,28263,55835,51211,863,2525,,0.917184562,0.015456255,0.045222531,,,
Johnson County,Tennessee,47,091,47091,18073,9713,8360,18073,16097,677,541,,0.890665634,0.037459193,0.029934156,,,
Knox County,Tennessee,47,093,47093,487401,238643,248758,487401,395867,39710,29579,,0.812199811,0.081472956,0.060687196,,,
Lake County,Tennessee,47,095,47095,6691,4181,2510,6691,4425,1493,295,,0.661336123,0.223135555,0.044089075,,,
Lauderdale County,Tennessee,47,097,47097,24933,12865,12068,24933,14891,8461,652,,0.597240605,0.339349457,0.026150082,,,
Lawrence County,Tennessee,47,099,47099,44901,22079,22822,44901,41952,595,1202,,0.934322175,0.013251375,0.026770005,,,
Lewis County,Tennessee,47,101,47101,12784,6368,6416,12784,11927,100,372,,0.932963079,0.007822278,0.029098874,,,
Lincoln County,Tennessee,47,103,47103,35617,17552,18065,35617,30956,2052,1393,,0.869135525,0.057612938,0.039110537,,,
Loudon County,Tennessee,47,105,47105,56996,28151,28845,56996,50404,787,5708,,0.884342761,0.013807987,0.100147379,,,
McMinn County,Tennessee,47,107,47107,54135,26679,27456,54135,48323,1699,2369,,0.892638773,0.031384502,0.043760968,,,
McNairy County,Tennessee,47,109,47109,25933,12811,13122,25933,23579,1363,520,,0.909227625,0.052558516,0.020051672,,,
Macon County,Tennessee,47,111,47111,25793,12778,13015,25793,23300,216,1751,,0.903345869,0.008374365,0.067886636,,,
Madison County,Tennessee,47,113,47113,98845,47316,51529,98845,53868,36151,4920,,0.544974455,0.36573423,0.0497749,,,
Marion County,Tennessee,47,115,47115,29010,14411,14599,29010,26483,817,672,,0.912892106,0.028162703,0.023164426,,,
Marshall County,Tennessee,47,117,47117,35276,17628,17648,35276,30905,1447,2402,,0.876091394,0.04101939,0.06809162,,,
Maury County,Tennessee,47,119,47119,104855,51406,53449,104855,83962,11099,8178,,0.800743884,0.105850937,0.077993419,,,
Meigs County,Tennessee,47,121,47121,13076,6450,6626,13076,11865,304,131,,0.90738758,0.0232487,0.010018354,,,
Monroe County,Tennessee,47,123,47123,47054,23382,23672,47054,41881,870,2095,,0.890062481,0.018489395,0.044523314,,,
Montgomery County,Tennessee,47,125,47125,227957,113691,114266,227957,146530,45621,25020,,0.642796668,0.200129849,0.109757542,,,
Moore County,Tennessee,47,127,47127,6611,3271,3340,6611,6096,195,109,,0.922099531,0.029496294,0.016487672,,,
Morgan County,Tennessee,47,129,47129,21193,11715,9478,21193,19625,974,378,,0.926013306,0.045958571,0.017836078,,,
Obion County,Tennessee,47,131,47131,30570,14779,15791,30570,24503,3226,1614,,0.801537455,0.105528296,0.05279686,,,
Overton County,Tennessee,47,133,47133,22807,11434,11373,22807,21879,314,454,,0.959310738,0.013767703,0.019906169,,,
Perry County,Tennessee,47,135,47135,8561,4268,4293,8561,7896,43,243,,0.922322159,0.005022778,0.028384535,,,
Pickett County,Tennessee,47,137,47137,5062,2477,2585,5062,4858,18,41,,0.959699723,0.003555907,0.008099565,,,
Polk County,Tennessee,47,139,47139,17702,8976,8726,17702,16094,144,369,,0.909162806,0.008134674,0.020845102,,,
Putnam County,Tennessee,47,141,47141,81366,40209,41157,81366,71391,2016,6538,,0.877405796,0.024776934,0.080352973,,,
Rhea County,Tennessee,47,143,47143,33299,16678,16621,33299,29670,538,2032,,0.891017748,0.016156641,0.061022854,,,
Roane County,Tennessee,47,145,47145,54403,26928,27475,54403,49989,1294,1225,,0.918864768,0.023785453,0.022517141,,,
Robertson County,Tennessee,47,147,47147,74291,36932,37359,74291,60576,5233,7150,,0.815388136,0.070439219,0.096243152,,,
Rutherford County,Tennessee,47,149,47149,351591,173415,178176,351591,239171,52801,40625,,0.680253476,0.150177337,0.115546189,,,
Scott County,Tennessee,47,151,47151,21969,10942,11027,21969,21221,86,29,,0.965952023,0.003914607,0.001320042,,,
Sequatchie County,Tennessee,47,153,47153,16409,8249,8160,16409,15304,77,719,,0.932658907,0.004692547,0.043817417,,,
Sevier County,Tennessee,47,155,47155,98802,48946,49856,98802,86681,862,8822,,0.877320297,0.00872452,0.08928969,,,
Shelby County,Tennessee,47,157,47157,922195,438537,483658,922195,322797,487064,78252,,0.350031176,0.528157277,0.084854071,,,
Smith County,Tennessee,47,159,47159,20196,10227,9969,20196,18344,392,599,,0.908298673,0.019409784,0.029659338,,,
Stewart County,Tennessee,47,161,47161,13859,6929,6930,13859,12915,179,399,,0.931885417,0.012915795,0.028789956,,,
Sullivan County,Tennessee,47,163,47163,159693,78096,81597,159693,148653,3212,3905,,0.930867352,0.020113593,0.02445317,,,
Sumner County,Tennessee,47,165,47165,200553,98319,102234,200553,162173,17253,13759,,0.80862914,0.086027135,0.068605306,,,
Tipton County,Tennessee,47,167,47167,61339,30295,31044,61339,45796,11419,1829,,0.746604933,0.186162148,0.029817897,,,
Trousdale County,Tennessee,47,169,47169,11805,7337,4468,11805,9508,1330,431,,0.805421432,0.112664125,0.036509953,,,
Unicoi County,Tennessee,47,171,47171,17779,8740,9039,17779,16447,82,1143,,0.925080151,0.004612183,0.06428933,,,
Union County,Tennessee,47,173,47173,20141,10053,10088,20141,19180,111,447,,0.952286381,0.005511146,0.022193536,,,
Van Buren County,Tennessee,47,175,47175,6293,3197,3096,6293,5983,24,29,,0.950738916,0.003813761,0.004608295,,,
Warren County,Tennessee,47,177,47177,41587,20804,20783,41587,35818,1172,4080,,0.861278765,0.028181884,0.098107582,,,
Washington County,Tennessee,47,179,47179,134693,66342,68351,134693,118113,5055,6356,,0.876905259,0.03752979,0.047188792,,,
Wayne County,Tennessee,47,181,47181,16251,9214,7037,16251,14504,683,415,,0.892498923,0.042028183,0.02553689,,,
Weakley County,Tennessee,47,183,47183,32959,16175,16784,32959,28560,2446,977,,0.866531145,0.074213417,0.02964289,,,
White County,Tennessee,47,185,47185,27764,13670,14094,27764,25842,336,837,,0.930773664,0.012102003,0.030146953,,,
Williamson County,Tennessee,47,187,47187,254609,125734,128875,254609,210781,9676,14809,,0.827861545,0.03800337,0.058163694,,,
Wilson County,Tennessee,47,189,47189,153587,76030,77557,153587,126077,11048,9258,,0.820883278,0.071933171,0.060278539,,,
Anderson County,Texas,48,001,48001,57825,35335,22490,57825,34824,10860,11182,,0.602230869,0.187808042,0.193376567,,,
Andrews County,Texas,48,003,48003,18518,9100,9418,18518,11040,347,10525,,0.596176693,0.018738525,0.568365914,,,
Angelina County,Texas,48,005,48005,86791,42650,44141,86791,58239,10603,20104,,0.671025798,0.122167045,0.231636921,,,
Aransas County,Texas,48,007,48007,24449,12264,12185,24449,19731,273,6542,,0.807026872,0.011166101,0.267577406,,,
Archer County,Texas,48,009,48009,8734,4447,4287,8734,7960,70,787,,0.911380811,0.008014655,0.090107625,,,
Armstrong County,Texas,48,011,48011,1883,910,973,1883,1744,10,180,,0.926181625,0.005310674,0.09559214,,,
Atascosa County,Texas,48,013,48013,50058,24874,25184,50058,27306,644,32389,,0.545487235,0.012865077,0.647029446,,,
Austin County,Texas,48,015,48015,30712,15570,15142,30712,21755,2858,8359,,0.70835504,0.093058088,0.272173743,,,
Bailey County,Texas,48,017,48017,7044,3418,3626,7044,5002,60,4548,,0.710107893,0.008517888,0.645655877,,,
Bandera County,Texas,48,019,48019,21589,10716,10873,21589,17081,238,4366,,0.791189958,0.011024133,0.202232618,,,
Bastrop County,Texas,48,021,48021,102370,51913,50457,102370,57919,5881,45026,,0.565780991,0.057448471,0.439835889,,,
Baylor County,Texas,48,023,48023,3464,1736,1728,3464,2803,26,473,,0.809180139,0.007505774,0.136547344,,,
Bee County,Texas,48,025,48025,31000,19230,11770,31000,17754,1883,19187,,0.572709677,0.060741935,0.618935484,,,
Bell County,Texas,48,027,48027,379811,189026,190785,379811,197699,88579,98037,,0.520519416,0.233218627,0.258120486,,,
Bexar County,Texas,48,029,48029,2037344,1010696,1026648,2037344,1006462,161052,1212855,,0.494006903,0.079049979,0.595311837,,,
Blanco County,Texas,48,031,48031,12008,5925,6083,12008,9686,92,2209,,0.806628914,0.007661559,0.183960693,,,
Borden County,Texas,48,033,48033,723,305,418,723,616,11,110,,0.852005533,0.015214385,0.152143845,,,
Bosque County,Texas,48,035,48035,18546,9109,9437,18546,14726,253,3492,,0.794025666,0.013641756,0.18828858,,,
Bowie County,Texas,48,037,48037,92321,46392,45929,92321,60611,22965,7726,,0.656524518,0.248751638,0.083686269,,,
Brazoria County,Texas,48,039,48039,381650,192838,188812,381650,204171,60242,119727,,0.534969213,0.157846194,0.313708896,,,
Brazos County,Texas,48,041,48041,237980,120125,117855,237980,157983,25666,64536,,0.663849903,0.107849399,0.271182452,,,
Brewster County,Texas,48,043,48043,9464,4548,4916,9464,7138,27,3980,,0.754226543,0.002852916,0.420540997,,,
Briscoe County,Texas,48,045,48045,1223,647,576,1223,1034,66,321,,0.845461979,0.053965658,0.262469338,,,
Brooks County,Texas,48,047,48047,6987,3503,3484,6987,3621,54,6290,,0.518248175,0.007728639,0.900243309,,,
Brown County,Texas,48,049,48049,38294,19165,19129,38294,29910,1276,8503,,0.781062307,0.033321147,0.222045229,,,
Burleson County,Texas,48,051,48051,18327,8752,9575,18327,13194,2119,4003,,0.719921427,0.11562176,0.218420909,,,
Burnet County,Texas,48,053,48053,51064,25162,25902,51064,41635,636,11782,,0.815349366,0.012454958,0.230730064,,,
Caldwell County,Texas,48,055,48055,47184,23885,23299,47184,27276,2025,26565,,0.578077314,0.042917091,0.563008647,,,
Calhoun County,Texas,48,057,48057,19921,10304,9617,19921,13102,495,9816,,0.657697907,0.02484815,0.492746348,,,
Callahan County,Texas,48,059,48059,14017,6928,7089,14017,11997,245,1487,,0.855889277,0.017478776,0.106085468,,,
Cameron County,Texas,48,061,48061,423192,208624,214568,423192,211525,2574,378059,,0.499832227,0.006082346,0.893351009,,,
Camp County,Texas,48,063,48063,12652,6143,6509,12652,7635,1843,3377,,0.603461903,0.145668669,0.266914322,,,
Carson County,Texas,48,065,48065,5802,2891,2911,5802,5277,35,608,,0.909513961,0.006032403,0.104791451,,,
Cass County,Texas,48,067,48067,28582,14027,14555,28582,21919,4789,1467,,0.766881254,0.167553005,0.051326009,,,
Castro County,Texas,48,069,48069,7328,3713,3615,7328,3957,86,4783,,0.539983624,0.011735808,0.652701965,,,
Chambers County,Texas,48,071,48071,49178,25118,24060,49178,35645,3580,12418,,0.724815975,0.072796779,0.252511286,,,
Cherokee County,Texas,48,073,48073,51143,26022,25121,51143,34347,6675,12143,,0.67158751,0.130516395,0.237432298,,,
Childress County,Texas,48,075,48075,6772,4159,2613,6772,4137,451,2305,,0.610897815,0.066597755,0.34037212,,,
Clay County,Texas,48,077,48077,10402,5242,5160,10402,9461,118,705,,0.909536628,0.011343972,0.067775428,,,
Cochran County,Texas,48,079,48079,2520,1317,1203,2520,1204,183,1501,,0.477777778,0.072619048,0.595634921,,,
Coke County,Texas,48,081,48081,3315,1665,1650,3315,2823,58,691,,0.85158371,0.017496229,0.208446456,,,
Coleman County,Texas,48,083,48083,7765,3947,3818,7765,6159,302,1252,,0.793174501,0.038892466,0.161236317,,,
Collin County,Texas,48,085,48085,1116601,555119,561482,1116601,636304,119522,178350,,0.569857989,0.107040922,0.159725811,,,
Collingsworth County,Texas,48,087,48087,2733,1300,1433,2733,1570,216,891,,0.5744603,0.079034029,0.326015368,,,
Colorado County,Texas,48,089,48089,20736,10442,10294,20736,13702,2703,6218,,0.660783179,0.130353009,0.299864969,,,
Comal County,Texas,48,091,48091,174552,86945,87607,174552,130460,4415,48664,,0.747399056,0.025293322,0.278793712,,,
Comanche County,Texas,48,093,48093,13786,6964,6822,13786,10170,70,4002,,0.737704918,0.005077615,0.290294502,,,
Concho County,Texas,48,095,48095,3301,2165,1136,3301,2566,122,1024,,0.7773402,0.036958497,0.310209028,,,
Cooke County,Texas,48,097,48097,42473,21316,21157,42473,33507,1411,8719,,0.788901184,0.033221105,0.205283356,,,
Coryell County,Texas,48,099,48099,83772,42282,41490,83772,51794,11608,16992,,0.618273409,0.138566585,0.20283627,,,
Cottle County,Texas,48,101,48101,1302,659,643,1302,855,64,338,,0.656682028,0.049155146,0.259600614,,,
Crane County,Texas,48,103,48103,4623,2247,2376,4623,1818,119,3160,,0.393251136,0.025740861,0.683538828,,,
Crockett County,Texas,48,105,48105,2881,1563,1318,2881,1070,17,1795,,0.37139882,0.005900729,0.623047553,,,
Crosby County,Texas,48,107,48107,5072,2568,2504,5072,3517,132,2831,,0.693414826,0.026025237,0.558162461,,,
Culberson County,Texas,48,109,48109,2181,1184,997,2181,1008,4,1899,,0.462173315,0.001834021,0.870701513,,,
Dallam County,Texas,48,111,48111,7180,3819,3361,7180,4472,14,3781,,0.622841226,0.001949861,0.526601671,,,
Dallas County,Texas,48,113,48113,2603816,1290882,1312934,2603816,1062078,586837,1061995,,0.407892877,0.225375756,0.407861001,,,
Dawson County,Texas,48,115,48115,12311,7173,5138,12311,6717,877,6815,,0.545609617,0.071237105,0.553569978,,,
Deaf Smith County,Texas,48,117,48117,18487,9396,9091,18487,9767,357,14000,,0.528317196,0.019310867,0.757288906,,,
Delta County,Texas,48,119,48119,5345,2410,2935,5345,4316,446,466,,0.80748363,0.08344247,0.087184284,,,
Denton County,Texas,48,121,48121,945644,467910,477734,945644,573342,101626,191815,,0.60629793,0.107467504,0.202840604,,,
DeWitt County,Texas,48,123,48123,19853,10393,9460,19853,12111,1466,7017,,0.610033748,0.073842744,0.353447842,,,
Dickens County,Texas,48,125,48125,1641,827,814,1641,1282,24,558,,0.781230957,0.014625229,0.340036563,,,
Dimmit County,Texas,48,127,48127,8507,4274,4233,8507,2592,60,7403,,0.304690255,0.007053015,0.870224521,,,
Donley County,Texas,48,129,48129,3276,1666,1610,3276,2856,177,399,,0.871794872,0.054029304,0.121794872,,,
Duval County,Texas,48,131,48131,9824,5050,4774,9824,6657,69,8038,,0.677626221,0.007023616,0.818200326,,,
Eastland County,Texas,48,133,48133,17846,8947,8899,17846,14719,405,3013,,0.824778662,0.022694161,0.168833352,,,
Ector County,Texas,48,135,48135,163206,83807,79399,163206,87032,8298,101602,,0.533264708,0.050843719,0.622538387,,,
Edwards County,Texas,48,137,48137,1392,772,620,1392,1191,22,610,,0.855603448,0.015804598,0.438218391,,,
Ellis County,Texas,48,139,48139,203927,101035,102892,203927,131379,27009,56354,,0.644245245,0.132444453,0.276343986,,,
El Paso County,Texas,48,141,48141,866275,430439,435836,866275,339519,28593,716543,,0.391929814,0.03300684,0.827154195,,,
Erath County,Texas,48,143,48143,43244,21162,22082,43244,34681,610,9508,,0.80198409,0.014106003,0.219868652,,,
Falls County,Texas,48,145,48145,17063,8079,8984,17063,9887,3453,4166,,0.579440896,0.202367696,0.244154017,,,
Fannin County,Texas,48,147,48147,36525,19517,17008,36525,30109,2312,4616,,0.824339493,0.06329911,0.126379192,,,
Fayette County,Texas,48,149,48149,24783,12430,12353,24783,19639,1490,5355,,0.792438365,0.060121858,0.216075536,,,
Fisher County,Texas,48,151,48151,3661,1882,1779,3661,2811,140,965,,0.767822999,0.038240918,0.263589183,,,
Floyd County,Texas,48,153,48153,5294,2666,2628,5294,3686,143,3051,,0.696259917,0.027011711,0.576312807,,,
Foard County,Texas,48,155,48155,1079,439,640,1079,787,3,118,,0.729379055,0.002780352,0.109360519,,,
Fort Bend County,Texas,48,157,48157,859721,423591,436130,859721,318338,176568,210272,,0.370280591,0.205378256,0.244581672,,,
Franklin County,Texas,48,159,48159,10522,5322,5200,10522,8282,543,1500,,0.787112716,0.051606159,0.142558449,,,
Freestone County,Texas,48,161,48161,19813,10375,9438,19813,13449,2903,3321,,0.67879675,0.146519962,0.167617221,,,
Frio County,Texas,48,163,48163,18019,10733,7286,18019,8391,814,13977,,0.465675121,0.045174538,0.775681225,,,
Gaines County,Texas,48,165,48165,21904,11298,10606,21904,16823,541,8723,,0.768033236,0.024698685,0.398237765,,,
Galveston County,Texas,48,167,48167,354721,175066,179655,354721,228663,43820,91727,,0.64462775,0.123533707,0.258589145,,,
Garza County,Texas,48,169,48169,5435,3406,2029,5435,3320,568,2717,,0.610855566,0.10450782,0.499908004,,,
Gillespie County,Texas,48,171,48171,27202,13380,13822,27202,23081,123,6092,,0.848503786,0.004521726,0.223954121,,,
Glasscock County,Texas,48,173,48173,1070,607,463,1070,729,0,290,,0.681308411,0,0.271028037,,,
Goliad County,Texas,48,175,48175,7096,3564,3532,7096,5339,361,2288,,0.752395716,0.050873732,0.322435175,,,
Gonzales County,Texas,48,177,48177,19764,9871,9893,19764,12826,1242,10035,,0.648957701,0.06284153,0.507741348,,,
Gray County,Texas,48,179,48179,21131,11261,9870,21131,16471,976,6499,,0.77947092,0.046188065,0.307557617,,,
Grayson County,Texas,48,181,48181,139988,68593,71395,139988,110428,7550,22190,,0.788839043,0.053933194,0.158513587,,,
Gregg County,Texas,48,183,48183,124860,61023,63837,124860,76025,24429,24748,,0.608881948,0.195651129,0.198205991,,,
Grimes County,Texas,48,185,48185,30385,16656,13729,30385,19302,3552,7691,,0.635247655,0.116899786,0.253118315,,,
Guadalupe County,Texas,48,187,48187,178368,89128,89240,178368,108064,14206,68626,,0.605848583,0.079644331,0.3847439,,,
Hale County,Texas,48,189,48189,32247,16772,15475,32247,20276,1316,19597,,0.628771669,0.040809998,0.607715446,,,
Hall County,Texas,48,191,48191,2827,1376,1451,2827,1773,140,975,,0.627166608,0.049522462,0.344888574,,,
Hamilton County,Texas,48,193,48193,8320,4139,4181,8320,7225,158,1129,,0.868389423,0.018990385,0.135697115,,,
Hansford County,Texas,48,195,48195,5182,2665,2517,5182,3687,11,2575,,0.711501351,0.002122733,0.496912389,,,
Hardeman County,Texas,48,197,48197,3529,1869,1660,3529,2746,121,949,,0.778124114,0.034287334,0.268914707,,,
Hardin County,Texas,48,199,48199,57126,28108,29018,57126,48845,3483,3723,,0.855039737,0.060970486,0.065171726,,,
Harris County,Texas,48,201,48201,4758579,2366425,2392154,4758579,1910341,909089,2065668,,0.401451988,0.191042116,0.434093455,,,
Harrison County,Texas,48,203,48203,69584,33828,35756,69584,45279,14214,10129,,0.650709933,0.204271097,0.145565072,,,
Hartley County,Texas,48,205,48205,5307,3125,2182,5307,3641,355,1629,,0.686074995,0.066892783,0.306953081,,,
Haskell County,Texas,48,207,48207,5390,2876,2514,5390,4222,328,1402,,0.783302412,0.060853432,0.260111317,,,
Hays County,Texas,48,209,48209,256429,127861,128568,256429,170650,10507,100152,,0.665486353,0.040974305,0.39056425,,,
Hemphill County,Texas,48,211,48211,3311,1801,1510,3311,2473,69,1099,,0.746904259,0.020839625,0.33192389,,,
Henderson County,Texas,48,213,48213,83658,41288,42370,83658,67374,4430,11964,,0.805350355,0.052953692,0.14301083,,,
Hidalgo County,Texas,48,215,48215,880921,434784,446137,880921,348336,6070,809705,,0.395422518,0.006890516,0.919157336,,,
Hill County,Texas,48,217,48217,36664,18377,18287,36664,28634,2255,8284,,0.780984072,0.061504473,0.225943705,,,
Hockley County,Texas,48,219,48219,21455,10676,10779,21455,13547,769,10644,,0.631414589,0.035842461,0.496108133,,,
Hood County,Texas,48,221,48221,64198,31122,33076,64198,55175,694,8569,,0.85945045,0.010810306,0.133477678,,,
Hopkins County,Texas,48,223,48223,37351,18392,18959,37351,30031,2641,6812,,0.804021311,0.070707612,0.182377982,,,
Houston County,Texas,48,225,48225,22042,11842,10200,22042,13899,4864,3096,,0.630568914,0.220669631,0.140459123,,,
Howard County,Texas,48,227,48227,33127,18653,14474,33127,23000,1862,15547,,0.694297703,0.056207927,0.46931506,,,
Hudspeth County,Texas,48,229,48229,3331,2031,1300,3331,1219,25,2181,,0.365956169,0.007505254,0.654758331,,,
Hunt County,Texas,48,231,48231,104917,51789,53128,104917,76798,8392,21575,,0.731988143,0.079987037,0.205638743,,,
Hutchinson County,Texas,48,233,48233,20413,10422,9991,20413,15112,492,5011,,0.740312546,0.024102288,0.245480821,,,
Irion County,Texas,48,235,48235,1432,688,744,1432,993,0,428,,0.693435754,0,0.298882682,,,
Jack County,Texas,48,237,48237,8623,4702,3921,8623,7511,305,1589,,0.871042561,0.035370521,0.184274614,,,
Jackson County,Texas,48,239,48239,15081,7643,7438,15081,10940,894,4948,,0.725416086,0.059279889,0.328094954,,,
Jasper County,Texas,48,241,48241,32807,16112,16695,32807,24577,5061,2248,,0.749138903,0.154265858,0.068521962,,,
Jeff Davis County,Texas,48,243,48243,1740,1001,739,1740,1254,11,540,,0.720689655,0.006321839,0.310344828,,,
Jefferson County,Texas,48,245,48245,253939,130676,123263,253939,111975,84147,59759,,0.440952355,0.331366982,0.235328169,,,
Jim Hogg County,Texas,48,247,48247,4797,2657,2140,4797,2661,23,3757,,0.554721701,0.004794663,0.783197832,,,
Jim Wells County,Texas,48,249,48249,38863,19374,19489,38863,30485,313,30860,,0.784422201,0.008053933,0.794071482,,,
Johnson County,Texas,48,251,48251,188820,95006,93814,188820,143407,9216,46403,,0.75949052,0.048808389,0.245752569,,,
Jones County,Texas,48,253,48253,19968,12849,7119,19968,13119,2100,5671,,0.657001202,0.105168269,0.284004407,,,
Karnes County,Texas,48,255,48255,14819,8483,6336,14819,8743,1074,7863,,0.589985829,0.072474526,0.530602605,,,
Kaufman County,Texas,48,257,48257,160718,79469,81249,160718,96408,27068,42372,,0.599858137,0.168419219,0.263641907,,,
Kendall County,Texas,48,259,48259,46971,23079,23892,46971,36524,415,11114,,0.77758617,0.008835239,0.236614081,,,
Kenedy County,Texas,48,261,48261,52,29,23,52,10,0,47,,0.192307692,0,0.903846154,,,
Kent County,Texas,48,263,48263,727,394,333,727,635,6,86,,0.873452545,0.008253095,0.11829436,,,
Kerr County,Texas,48,265,48265,53166,25923,27243,53166,41107,850,14049,,0.773182109,0.015987661,0.264247828,,,
Kimble County,Texas,48,267,48267,4355,2119,2236,4355,3440,98,1114,,0.78989667,0.02250287,0.255797933,,,
King County,Texas,48,269,48269,189,94,95,189,153,0,49,,0.80952381,0,0.259259259,,,
Kinney County,Texas,48,271,48271,3140,1689,1451,3140,2259,3,1678,,0.719426752,0.000955414,0.534394904,,,
Kleberg County,Texas,48,273,48273,30629,15409,15220,30629,16355,1051,21830,,0.533971073,0.034313886,0.712723236,,,
Knox County,Texas,48,275,48275,3322,1639,1683,3322,2375,132,1124,,0.714930765,0.039735099,0.338350391,,,
Lamar County,Texas,48,277,48277,50421,24743,25678,50421,38898,6254,4659,,0.771464271,0.12403562,0.092401975,,,
Lamb County,Texas,48,279,48279,12919,6585,6334,12919,9208,393,7445,,0.712748665,0.030420311,0.576282994,,,
Lampasas County,Texas,48,281,48281,22267,11091,11176,22267,17206,904,4477,,0.772712983,0.040598195,0.201059864,,,
La Salle County,Texas,48,283,48283,6946,4130,2816,6946,2966,240,5629,,0.42700835,0.03455226,0.810394472,,,
Lavaca County,Texas,48,285,48285,20479,10104,10375,20479,15491,817,4046,,0.75643342,0.039894526,0.197568241,,,
Lee County,Texas,48,287,48287,17758,8770,8988,17758,13194,1841,4649,,0.742989075,0.103671585,0.2617975,,,
Leon County,Texas,48,289,48289,16067,7891,8176,16067,12852,1172,2594,,0.799900417,0.072944545,0.161448933,,,
Liberty County,Texas,48,291,48291,97993,48669,49324,97993,61723,7907,36192,,0.629871521,0.080689437,0.369332503,,,
Limestone County,Texas,48,293,48293,22185,11220,10965,22185,13546,3809,5126,,0.610592743,0.171692585,0.231057021,,,
Lipscomb County,Texas,48,295,48295,2964,1407,1557,2964,2079,12,1095,,0.701417004,0.004048583,0.369433198,,,
Live Oak County,Texas,48,297,48297,11444,6110,5334,11444,8817,269,4815,,0.770447396,0.023505767,0.420744495,,,
Llano County,Texas,48,299,48299,22011,10659,11352,22011,19333,231,2787,,0.87833356,0.010494753,0.126618509,,,
Loving County,Texas,48,301,48301,54,34,20,54,49,0,0,,0.907407407,0,0,,,
Lubbock County,Texas,48,303,48303,314633,155226,159407,314633,210030,23187,112607,,0.667539641,0.073695385,0.357899521,,,
Lynn County,Texas,48,305,48305,5667,2946,2721,5667,3664,90,2356,,0.646550203,0.015881419,0.415740251,,,
McCulloch County,Texas,48,307,48307,7565,3769,3796,7565,5662,58,2325,,0.748446794,0.007666887,0.307336418,,,
McLennan County,Texas,48,309,48309,263608,129082,134526,263608,167794,37077,70219,,0.636528482,0.140652029,0.266376589,,,
McMullen County,Texas,48,311,48311,623,267,356,623,384,0,339,,0.616372392,0,0.544141252,,,
Madison County,Texas,48,313,48313,13574,7641,5933,13574,8442,2129,3509,,0.621924267,0.156843966,0.258508914,,,
Marion County,Texas,48,315,48315,9631,4705,4926,9631,6881,2085,436,,0.714463711,0.216488423,0.045270481,,,
Martin County,Texas,48,317,48317,5230,3001,2229,5230,3999,64,2383,,0.764627151,0.012237094,0.455640535,,,
Mason County,Texas,48,319,48319,3951,1991,1960,3951,3342,3,826,,0.845861807,0.000759301,0.209060997,,,
Matagorda County,Texas,48,321,48321,36274,18050,18224,36274,20293,3810,15678,,0.559436511,0.105033909,0.432210399,,,
Maverick County,Texas,48,323,48323,57770,28860,28910,57770,20020,135,54797,,0.346546651,0.002336853,0.948537303,,,
Medina County,Texas,48,325,48325,52419,27114,25305,52419,34127,1492,26780,,0.651042561,0.028462962,0.510883458,,,
Menard County,Texas,48,327,48327,1964,1032,932,1964,1594,8,549,,0.811608961,0.00407332,0.279531568,,,
Midland County,Texas,48,329,48329,171496,87327,84169,171496,102681,12427,76792,,0.598736997,0.072462331,0.447777208,,,
Milam County,Texas,48,331,48331,25268,12585,12683,25268,18542,2430,6466,,0.733813519,0.096169068,0.255896786,,,
Mills County,Texas,48,333,48333,4499,2300,2199,4499,3648,27,851,,0.810846855,0.006001334,0.189153145,,,
Mitchell County,Texas,48,335,48335,8989,5619,3370,8989,5779,531,3481,,0.642896874,0.059072199,0.387251085,,,
Montague County,Texas,48,337,48337,20599,10027,10572,20599,18809,10,2463,,0.913102578,0.00048546,0.119568911,,,
Montgomery County,Texas,48,339,48339,654722,325669,329053,654722,467109,39061,177581,,0.713446318,0.059660436,0.271231148,,,
Moore County,Texas,48,341,48341,21234,11153,10081,21234,13014,997,12743,,0.612884996,0.046953,0.600122445,,,
Morris County,Texas,48,343,48343,12014,5783,6231,12014,7853,2229,1288,,0.65365407,0.185533544,0.107208257,,,
Motley County,Texas,48,345,48345,1267,694,573,1267,1075,33,102,,0.848460931,0.026045777,0.08050513,,,
Nacogdoches County,Texas,48,347,48347,64897,31354,33543,64897,42724,11335,13825,,0.658335516,0.174661387,0.213029878,,,
Navarro County,Texas,48,349,48349,53735,26535,27200,53735,32907,5880,16796,,0.612394157,0.109425886,0.31257095,,,
Newton County,Texas,48,351,48351,12193,6197,5996,12193,9187,2185,415,,0.753465103,0.179201181,0.034035922,,,
Nolan County,Texas,48,353,48353,14565,7429,7136,14565,10042,618,5396,,0.689461037,0.042430484,0.370477171,,,
Nueces County,Texas,48,355,48355,352829,175595,177234,352829,193284,14126,219138,,0.547812113,0.040036392,0.621088403,,,
Ochiltree County,Texas,48,357,48357,9852,4961,4891,9852,6802,0,5484,,0.690418189,0,0.556638246,,,
Oldham County,Texas,48,359,48359,2097,1247,850,2097,1716,155,513,,0.818311874,0.073915117,0.244635193,,,
Orange County,Texas,48,361,48361,84993,42187,42806,84993,68653,7347,7763,,0.807748873,0.086442413,0.091336934,,,
Palo Pinto County,Texas,48,363,48363,28920,14261,14659,28920,23784,737,5846,,0.822406639,0.025484094,0.202143845,,,
Panola County,Texas,48,365,48365,22624,11459,11165,22624,16794,2589,2266,,0.742309052,0.114435997,0.100159123,,,
Parker County,Texas,48,367,48367,158079,79157,78922,158079,134222,2251,22268,,0.849081788,0.014239716,0.140866276,,,
Parmer County,Texas,48,369,48369,9752,5151,4601,9752,6536,35,6446,,0.670221493,0.003589007,0.660992617,,,
Pecos County,Texas,48,371,48371,14983,8615,6368,14983,8767,647,10666,,0.585129814,0.043182273,0.711873457,,,
Polk County,Texas,48,373,48373,51780,27835,23945,51780,39920,4073,7799,,0.770954036,0.078659714,0.150617999,,,
Potter County,Texas,48,375,48375,116634,60016,56618,116634,72161,12309,45218,,0.618696092,0.105535264,0.387691411,,,
Presidio County,Texas,48,377,48377,6043,3129,2914,6043,2231,65,4622,,0.36918749,0.010756247,0.764851895,,,
Rains County,Texas,48,379,48379,12505,6255,6250,12505,10903,357,1228,,0.871891244,0.028548581,0.09820072,,,
Randall County,Texas,48,381,48381,143791,71055,72736,143791,111928,5230,34127,,0.77840755,0.036372235,0.237337525,,,
Reagan County,Texas,48,383,48383,3259,1687,1572,3259,1243,177,2186,,0.381405339,0.054311138,0.670757901,,,
Real County,Texas,48,385,48385,2821,1546,1275,2821,2668,39,664,,0.945763914,0.013824885,0.235377526,,,
Red River County,Texas,48,387,48387,11621,5656,5965,11621,8957,1903,826,,0.770759831,0.163755271,0.07107822,,,
Reeves County,Texas,48,389,48389,13219,7846,5373,13219,5507,201,11206,,0.416597322,0.015205386,0.847719192,,,
Refugio County,Texas,48,391,48391,6693,3208,3485,6693,4143,493,3354,,0.619004931,0.073659047,0.501120574,,,
Roberts County,Texas,48,393,48393,785,411,374,785,747,2,83,,0.951592357,0.002547771,0.105732484,,,
Robertson County,Texas,48,395,48395,16973,8341,8632,16973,10770,3478,3712,,0.634537206,0.204913686,0.218700289,,,
Rockwall County,Texas,48,397,48397,116931,58114,58817,116931,83206,9947,23581,,0.711582044,0.085067262,0.20166594,,,
Runnels County,Texas,48,399,48399,9880,4971,4909,9880,6882,296,3402,,0.696558704,0.029959514,0.344331984,,,
Rusk County,Texas,48,401,48401,52613,27957,24656,52613,35558,6920,9839,,0.675840572,0.131526429,0.187007013,,,
Sabine County,Texas,48,403,48403,9998,5024,4974,9998,8659,459,417,,0.866073215,0.045909182,0.041708342,,,
San Augustine County,Texas,48,405,48405,7889,3787,4102,7889,5574,1746,643,,0.706553429,0.221320826,0.081505894,,,
San Jacinto County,Texas,48,407,48407,27983,13883,14100,27983,20489,2365,5129,,0.732194547,0.084515599,0.183289855,,,
San Patricio County,Texas,48,409,48409,69519,35450,34069,69519,44690,1122,39012,,0.642845841,0.016139473,0.561170328,,,
San Saba County,Texas,48,411,48411,5802,3062,2740,5802,4503,141,1753,,0.776111686,0.024301965,0.302137194,,,
Schleicher County,Texas,48,413,48413,2426,1152,1274,2426,1441,18,1282,,0.593981863,0.007419621,0.52844188,,,
Scurry County,Texas,48,415,48415,16633,8910,7723,16633,11460,445,7089,,0.688991763,0.026754043,0.426200926,,,
Shackelford County,Texas,48,417,48417,3169,1531,1638,3169,2751,37,401,,0.868097192,0.011675607,0.12653834,,,
Shelby County,Texas,48,419,48419,24108,12082,12026,24108,16166,3751,4736,,0.670565787,0.155591505,0.196449311,,,
Sherman County,Texas,48,421,48421,2434,1211,1223,2434,1667,4,1149,,0.684880855,0.001643385,0.472062449,,,
Smith County,Texas,48,423,48423,238014,115366,122648,238014,164335,39645,49012,,0.690442579,0.166565832,0.20592066,,,
Somervell County,Texas,48,425,48425,9510,4791,4719,9510,7939,183,1719,,0.834805468,0.019242902,0.180757098,,,
Starr County,Texas,48,427,48427,65809,32110,33699,65809,29115,217,64036,,0.442416691,0.003297421,0.973058396,,,
Stephens County,Texas,48,429,48429,9278,5081,4197,9278,7361,298,2308,,0.793382194,0.032118991,0.248760509,,,
Sterling County,Texas,48,431,48431,1389,743,646,1389,1135,2,447,,0.817134629,0.001439885,0.321814255,,,
Stonewall County,Texas,48,433,48433,1244,594,650,1244,1147,7,283,,0.922025723,0.00562701,0.227491961,,,
Sutton County,Texas,48,435,48435,3306,1678,1628,3306,1628,4,2162,,0.492437992,0.001209921,0.653962492,,,
Swisher County,Texas,48,437,48437,6981,3958,3023,6981,4827,561,3194,,0.691448217,0.08036098,0.457527575,,,
Tarrant County,Texas,48,439,48439,2135743,1049149,1086594,2135743,1112743,374520,637594,,0.521009784,0.175358177,0.298534983,,,
Taylor County,Texas,48,441,48441,144259,70882,73377,144259,101650,11567,35709,,0.704635413,0.080182172,0.247533949,,,
Terrell County,Texas,48,443,48443,851,458,393,851,710,0,364,,0.834312573,0,0.42773208,,,
Terry County,Texas,48,445,48445,11699,6216,5483,11699,6660,519,6574,,0.569279426,0.044362766,0.56192837,,,
Throckmorton County,Texas,48,447,48447,1589,838,751,1589,1481,0,124,,0.932032725,0,0.078036501,,,
Titus County,Texas,48,449,48449,31284,15669,15615,31284,17748,2978,13887,,0.567318757,0.095192431,0.443901036,,,
Tom Green County,Texas,48,451,48451,119398,59705,59693,119398,82355,4487,47877,,0.689751922,0.037580194,0.400986616,,,
Travis County,Texas,48,453,48453,1307625,666411,641214,1307625,781848,106691,425105,,0.59791454,0.081591435,0.325097027,,,
Trinity County,Texas,48,455,48455,13850,6811,7039,13850,11085,1258,1480,,0.800361011,0.090830325,0.106859206,,,
Tyler County,Texas,48,457,48457,20084,10887,9197,20084,16183,2130,1614,,0.805765784,0.106054571,0.080362478,,,
Upshur County,Texas,48,459,48459,41864,20851,21013,41864,34059,2995,4219,,0.813562966,0.071541181,0.100778712,,,
Upton County,Texas,48,461,48461,3227,1642,1585,3227,1397,30,1812,,0.432909823,0.00929656,0.56151224,,,
Uvalde County,Texas,48,463,48463,24810,12475,12335,24810,16673,354,17548,,0.672027408,0.01426844,0.707295445,,,
Val Verde County,Texas,48,465,48465,47647,24617,23030,47647,29628,671,38580,,0.62182299,0.014082733,0.809704703,,,
Van Zandt County,Texas,48,467,48467,61323,30161,31162,61323,54161,1667,7835,,0.883208584,0.027183928,0.127766091,,,
Victoria County,Texas,48,469,48469,91281,44916,46365,91281,56218,5244,43432,,0.615878441,0.057448976,0.47580548,,,
Walker County,Texas,48,471,48471,78292,46296,31996,78292,48459,15921,16931,,0.618952128,0.20335411,0.216254534,,,
Waller County,Texas,48,473,48473,59455,29741,29714,59455,27731,14046,19593,,0.466419981,0.2362459,0.329543352,,,
Ward County,Texas,48,475,48475,11255,5728,5527,11255,7263,714,6238,,0.645313194,0.063438472,0.554242559,,,
Washington County,Texas,48,477,48477,36156,17843,18313,36156,24952,5486,6557,,0.690120589,0.151731386,0.181353026,,,
Webb County,Texas,48,479,48479,267731,132784,134947,267731,100976,1207,254619,,0.377154681,0.004508256,0.95102547,,,
Wharton County,Texas,48,481,48481,41651,20617,21034,41651,26407,5541,17294,,0.634006386,0.133034021,0.41521212,,,
Wheeler County,Texas,48,483,48483,4902,2456,2446,4902,4017,81,1224,,0.819461444,0.016523868,0.249694002,,,
Wichita County,Texas,48,485,48485,129842,67214,62628,129842,95929,13432,26409,,0.738813327,0.103448807,0.203393355,,,
Wilbarger County,Texas,48,487,48487,12712,6111,6601,12712,8474,787,3798,,0.666614223,0.061910006,0.298772813,,,
Willacy County,Texas,48,489,48489,20218,10941,9277,20218,11486,293,17623,,0.568107627,0.014492037,0.871649026,,,
Williamson County,Texas,48,491,48491,643889,320207,323682,643889,410837,44429,157980,,0.638055628,0.069001023,0.245352848,,,
Wilson County,Texas,48,493,48493,51501,25875,25626,51501,37157,912,20354,,0.721481136,0.017708394,0.395215627,,,
Winkler County,Texas,48,495,48495,7540,4042,3498,7540,4389,323,4660,,0.582095491,0.042838196,0.618037135,,,
Wise County,Texas,48,497,48497,72359,36522,35837,72359,61099,1094,14878,,0.844387015,0.015119059,0.205613676,,,
Wood County,Texas,48,499,48499,46094,23014,23080,46094,38804,1858,5153,,0.841844926,0.040308934,0.111793292,,,
Yoakum County,Texas,48,501,48501,7589,3974,3615,7589,4465,11,4950,,0.588351561,0.001449466,0.65225985,,,
Young County,Texas,48,503,48503,17963,8945,9018,17963,14942,311,3621,,0.831820965,0.017313366,0.201581028,,,
Zapata County,Texas,48,505,48505,13855,6919,6936,13855,5478,37,13014,,0.395380729,0.002670516,0.939299892,,,
Zavala County,Texas,48,507,48507,9532,5028,4504,9532,3469,79,8831,,0.363932018,0.008287872,0.926458246,,,
Beaver County,Utah,49,001,49001,7172,3800,3372,7172,6513,11,1057,,0.908114891,0.001533742,0.147378695,,,
Box Elder County,Utah,49,003,49003,59725,30567,29158,59725,53354,213,5929,,0.893327752,0.003566346,0.099271662,,,
Cache County,Utah,49,005,49005,137031,68673,68358,137031,116959,1117,15806,,0.853522196,0.00815144,0.115346163,,,
Carbon County,Utah,49,007,49007,20446,10243,10203,20446,18221,155,2701,,0.891176758,0.007580945,0.132104079,,,
Daggett County,Utah,49,009,49009,747,422,325,747,692,0,22,,0.926372155,0,0.029451138,,,
Davis County,Utah,49,011,49011,366742,185874,180868,366742,313559,4433,41283,,0.854985248,0.012087517,0.112566873,,,
Duchesne County,Utah,49,013,49013,19932,10046,9886,19932,17576,15,1416,,0.881798114,0.000752559,0.071041541,,,
Emery County,Utah,49,015,49015,9968,5043,4925,9968,9384,4,730,,0.94141252,0.000401284,0.07323435,,,
Garfield County,Utah,49,017,49017,5170,2678,2492,5170,4896,7,361,,0.947001934,0.001353965,0.069825919,,,
Grand County,Utah,49,019,49019,9697,4990,4707,9697,8156,2,1212,,0.841084872,0.000206249,0.124987109,,,
Iron County,Utah,49,021,49021,60201,30024,30177,60201,52872,380,6070,,0.878257836,0.006312188,0.10082889,,,
Juab County,Utah,49,023,49023,12273,6462,5811,12273,11517,89,641,,0.938401369,0.007251691,0.052228469,,,
Kane County,Utah,49,025,49025,7996,4074,3922,7996,7259,18,384,,0.907828914,0.002251126,0.048024012,,,
Millard County,Utah,49,027,49027,13179,6804,6375,13179,11345,47,1755,,0.860839214,0.00356628,0.133166401,,,
Morgan County,Utah,49,029,49029,12585,6529,6056,12585,11871,20,363,,0.943265793,0.001589193,0.028843862,,,
Piute County,Utah,49,031,49031,1705,905,800,1705,1633,2,75,,0.957771261,0.001173021,0.04398827,,,
Rich County,Utah,49,033,49033,2588,1313,1275,2588,2317,0,180,,0.895285935,0,0.069551777,,,
Salt Lake County,Utah,49,035,49035,1184689,598699,585990,1184689,862251,21338,236654,,0.727828991,0.018011478,0.199760443,,,
San Juan County,Utah,49,037,49037,14466,7290,7176,14466,6749,17,804,,0.466542237,0.001175169,0.055578598,,,
Sanpete County,Utah,49,039,49039,29209,15577,13632,29209,25316,258,3057,,0.866719162,0.008832894,0.104659523,,,
Sevier County,Utah,49,041,49041,21854,11201,10653,21854,20304,43,1139,,0.929074769,0.001967603,0.052118605,,,
Summit County,Utah,49,043,49043,42709,21946,20763,42709,37047,190,4762,,0.867428411,0.004448711,0.111498747,,,
Tooele County,Utah,49,045,49045,76648,38972,37676,76648,66041,646,10922,,0.861614132,0.008428139,0.142495564,,,
Uintah County,Utah,49,047,49047,36458,18380,18078,36458,30651,189,3069,,0.840720829,0.005184047,0.084179055,,,
Utah County,Utah,49,049,49049,683622,346841,336781,683622,572479,4597,94727,,0.837420387,0.006724476,0.138566342,,,
Wasatch County,Utah,49,051,49051,35808,18481,17327,35808,30455,20,5146,,0.850508266,0.000558534,0.143710903,,,
Washington County,Utah,49,053,49053,189827,94634,95193,189827,163050,973,22296,,0.858939982,0.00512572,0.117454314,,,
Wayne County,Utah,49,055,49055,2557,1315,1242,2557,2417,0,98,,0.945248338,0,0.038326163,,,
Weber County,Utah,49,057,49057,266183,134779,131404,266183,223245,2988,50354,,0.838689924,0.01122536,0.189170608,,,
Addison County,Vermont,50,001,50001,37497,18641,18856,37497,34035,398,1184,,0.907672614,0.010614182,0.031575859,,,
Bennington County,Vermont,50,003,50003,37312,18131,19181,37312,34574,381,1023,,0.926618782,0.010211192,0.027417453,,,
Caledonia County,Vermont,50,005,50005,30425,15391,15034,30425,28388,271,643,,0.93304848,0.008907149,0.021133936,,,
Chittenden County,Vermont,50,007,50007,168831,83058,85773,168831,147173,4346,4773,,0.871717872,0.025741718,0.028270874,,,
Essex County,Vermont,50,009,50009,5972,3008,2964,5972,5654,3,89,,0.946751507,0.000502344,0.01490288,,,
Franklin County,Vermont,50,011,50011,50379,25106,25273,50379,46649,138,973,,0.925961214,0.002739237,0.019313603,,,
Grand Isle County,Vermont,50,013,50013,7393,3851,3542,7393,6780,35,155,,0.917083728,0.004734208,0.020965778,,,
Lamoille County,Vermont,50,015,50015,26036,13045,12991,26036,24026,296,642,,0.922799201,0.011368874,0.024658166,,,
Orange County,Vermont,50,017,50017,29594,14809,14785,29594,27749,110,506,,0.937656282,0.00371697,0.01709806,,,
Orleans County,Vermont,50,019,50019,27492,13898,13594,27492,25972,232,500,,0.944711189,0.008438819,0.018187109,,,
Rutland County,Vermont,50,021,50021,60484,30251,30233,60484,56765,412,1279,,0.938512665,0.006811719,0.021146088,,,
Washington County,Vermont,50,023,50023,59958,29874,30084,59958,55895,531,1614,,0.932235898,0.008856199,0.026918843,,,
Windham County,Vermont,50,025,50025,45913,22727,23186,45913,42115,398,1383,,0.917278331,0.008668569,0.030122188,,,
Windsor County,Vermont,50,027,50027,57968,28531,29437,57968,54060,336,1294,,0.932583494,0.005796301,0.022322661,,,
Accomack County,Virginia,51,001,51001,33326,16243,17083,33326,20240,9077,3528,,0.607333613,0.272369921,0.10586329,,,
Albemarle County,Virginia,51,003,51003,113683,54659,59024,113683,87040,10044,8348,,0.765637782,0.088350941,0.073432263,,,
Alleghany County,Virginia,51,005,51005,14962,7418,7544,14962,13824,828,225,,0.92394065,0.055340195,0.015038097,,,
Amelia County,Virginia,51,007,51007,13342,6641,6701,13342,9785,2714,252,,0.733398291,0.203417778,0.018887723,,,
Amherst County,Virginia,51,009,51009,31385,14948,16437,31385,23388,5558,890,,0.74519675,0.177090967,0.028357496,,,
Appomattox County,Virginia,51,011,51011,16424,7985,8439,16424,12693,2799,368,,0.77283244,0.170421335,0.022406235,,,
Arlington County,Virginia,51,013,51013,235463,118459,117004,235463,147496,22214,37054,,0.626408395,0.094341786,0.15736655,,,
Augusta County,Virginia,51,015,51015,77713,39868,37845,77713,69972,3320,2931,,0.900389896,0.042721295,0.037715698,,,
Bath County,Virginia,51,017,51017,4123,2064,2059,4123,3751,155,153,,0.909774436,0.037593985,0.037108901,,,
Bedford County,Virginia,51,019,51019,80254,39545,40709,80254,69464,4809,2174,,0.865551873,0.059922247,0.027088992,,,
Bland County,Virginia,51,021,51021,6211,3561,2650,6211,5789,310,41,,0.93205603,0.049911447,0.006601191,,,
Botetourt County,Virginia,51,023,51023,33875,16866,17009,33875,31066,800,803,,0.917077491,0.023616236,0.023704797,,,
Brunswick County,Virginia,51,025,51025,15868,8491,7377,15868,6539,8478,434,,0.41208722,0.534282833,0.027350643,,,
Buchanan County,Virginia,51,027,51027,19857,10302,9555,19857,19106,474,202,,0.962179584,0.023870675,0.010172735,,,
Buckingham County,Virginia,51,029,51029,16914,9453,7461,16914,10377,5424,434,,0.613515431,0.320681093,0.025659217,,,
Campbell County,Virginia,51,031,51031,55398,27003,28395,55398,43153,7968,1862,,0.778963139,0.143831907,0.033611322,,,
Caroline County,Virginia,51,033,51033,31541,15831,15710,31541,19667,7532,2220,,0.623537618,0.238800292,0.070384579,,,
Carroll County,Virginia,51,035,51035,29158,14442,14716,29158,27606,136,1128,,0.946772755,0.004664243,0.038685781,,,
Charles City County,Virginia,51,036,51036,6686,3314,3372,6686,3002,2709,133,,0.448997906,0.405174993,0.019892312,,,
Charlotte County,Virginia,51,037,51037,11475,5738,5737,11475,8077,2889,282,,0.703877996,0.251764706,0.024575163,,,
Chesterfield County,Virginia,51,041,51041,371610,179843,191767,371610,220926,87245,42400,,0.594510374,0.234775706,0.114098114,,,
Clarke County,Virginia,51,043,51043,15060,7335,7725,15060,12750,902,1063,,0.846613546,0.059893758,0.070584329,,,
Craig County,Virginia,51,045,51045,4881,2440,2441,4881,4648,3,38,,0.95226388,0.000614628,0.00778529,,,
Culpeper County,Virginia,51,047,51047,53563,26924,26639,53563,36643,7069,7912,,0.6841103,0.131975431,0.147713907,,,
Cumberland County,Virginia,51,049,51049,9745,4914,4831,9745,6235,2807,172,,0.63981529,0.288045151,0.017650077,,,
Dickenson County,Virginia,51,051,51051,13920,7114,6806,13920,13611,141,101,,0.977801724,0.01012931,0.007255747,,,
Dinwiddie County,Virginia,51,053,51053,28083,14033,14050,28083,18084,8595,1170,,0.643948296,0.306057045,0.041662216,,,
Essex County,Virginia,51,057,51057,10604,4828,5776,10604,5925,3976,461,,0.558751415,0.374952848,0.043474161,,,
Fairfax County,Virginia,51,059,51059,1144474,571515,572959,1144474,587697,112326,199153,,0.513508389,0.098146397,0.174012691,,,
Fauquier County,Virginia,51,061,51061,73935,36711,37224,73935,59895,4641,8624,,0.810103469,0.062771353,0.116642997,,,
Floyd County,Virginia,51,063,51063,15560,7706,7854,15560,14549,433,471,,0.935025707,0.027827763,0.030269923,,,
Fluvanna County,Virginia,51,065,51065,27764,12732,15032,27764,21296,3512,1212,,0.76703645,0.126494741,0.043653652,,,
Franklin County,Virginia,51,067,51067,54958,27184,27774,54958,47645,4282,1982,,0.86693475,0.077914043,0.036063903,,,
Frederick County,Virginia,51,069,51069,93355,47022,46333,93355,76923,3896,10952,,0.823983718,0.041733169,0.117315623,,,
Giles County,Virginia,51,071,51071,16610,8185,8425,16610,15728,373,280,,0.946899458,0.022456352,0.016857315,,,
Gloucester County,Virginia,51,073,51073,39228,19551,19677,39228,32969,3192,1586,,0.8404456,0.08137045,0.040430305,,,
Goochland County,Virginia,51,075,51075,25613,12748,12865,25613,20247,3680,934,,0.790497013,0.143677039,0.036465857,,,
Grayson County,Virginia,51,077,51077,15323,8104,7219,15323,13749,802,622,,0.897278601,0.05233962,0.040592573,,,
Greene County,Virginia,51,079,51079,20850,9966,10884,20850,16668,1411,1449,,0.79942446,0.067673861,0.069496403,,,
Greensville County,Virginia,51,081,51081,11304,7086,4218,11304,4101,6040,577,,0.362791932,0.534324133,0.051043878,,,
Halifax County,Virginia,51,083,51083,33811,16237,17574,33811,20387,11734,840,,0.602969448,0.347046819,0.024843986,,,
Hanover County,Virginia,51,085,51085,111652,55241,56411,111652,91848,9599,4203,,0.82262745,0.085972486,0.03764375,,,
Henrico County,Virginia,51,087,51087,334434,159424,175010,334434,171583,99183,22374,,0.513054893,0.296569727,0.066901093,,,
Henry County,Virginia,51,089,51089,50365,24204,26161,50365,35130,11273,3367,,0.69750819,0.22382607,0.066851981,,,
Highland County,Virginia,51,091,51091,2265,1017,1248,2265,2139,0,0,,0.944370861,0,0,,,
Isle of Wight County,Virginia,51,093,51093,39444,19755,19689,39444,27699,8718,1519,,0.702236082,0.221022209,0.038510293,,,
James City County,Virginia,51,095,51095,80046,38589,41457,80046,59921,10254,5531,,0.748582065,0.128101342,0.069097769,,,
King and Queen County,Virginia,51,097,51097,6676,3366,3310,6676,4457,1592,208,,0.667615339,0.238466147,0.031156381,,,
King George County,Virginia,51,099,51099,27468,13882,13586,27468,19555,4316,1811,,0.711919324,0.157128295,0.065931265,,,
King William County,Virginia,51,101,51101,18232,8978,9254,18232,14330,2788,565,,0.785980693,0.152917946,0.030989469,,,
Lancaster County,Virginia,51,103,51103,10876,5179,5697,10876,7364,3026,172,,0.677087164,0.278227289,0.015814638,,,
Lee County,Virginia,51,105,51105,22042,11709,10333,22042,20507,937,507,,0.930360221,0.042509754,0.023001543,,,
Loudoun County,Virginia,51,107,51107,427082,213723,213359,427082,236450,32889,60466,,0.553640753,0.077008631,0.141579369,,,
Louisa County,Virginia,51,109,51109,39012,19470,19542,39012,30137,5201,1520,,0.772505896,0.133317953,0.038962371,,,
Lunenburg County,Virginia,51,111,51111,11990,6321,5669,11990,6930,4021,689,,0.577981651,0.335362802,0.057464554,,,
Madison County,Virginia,51,113,51113,13931,6731,7200,13931,11797,1166,490,,0.846816453,0.083698227,0.035173354,,,
Mathews County,Virginia,51,115,51115,8517,4208,4309,8517,7387,713,219,,0.867324175,0.083714923,0.025713279,,,
Mecklenburg County,Virginia,51,117,51117,30431,14964,15467,30431,18828,10026,912,,0.618711183,0.329466662,0.029969439,,,
Middlesex County,Virginia,51,119,51119,10774,5337,5437,10774,8546,1631,317,,0.793205866,0.151382959,0.029422684,,,
Montgomery County,Virginia,51,121,51121,99159,51220,47939,99159,81977,3907,4512,,0.826722738,0.039401365,0.045502678,,,
Nelson County,Virginia,51,125,51125,14777,7520,7257,14777,12051,1515,692,,0.815524125,0.102524193,0.046829532,,,
New Kent County,Virginia,51,127,51127,24139,12560,11579,24139,18829,3234,862,,0.780024028,0.133974067,0.035709847,,,
Northampton County,Virginia,51,131,51131,12115,5834,6281,12115,6949,3811,1115,,0.573586463,0.314568716,0.092034668,,,
Northumberland County,Virginia,51,133,51133,12085,5697,6388,12085,8344,2374,403,,0.690442698,0.19644187,0.033347125,,,
Nottoway County,Virginia,51,135,51135,15597,8510,7087,15597,8626,5856,745,,0.553055075,0.375456819,0.047765596,,,
Orange County,Virginia,51,137,51137,37208,18626,18582,37208,28736,3876,2438,,0.772307031,0.104171146,0.065523543,,,
Page County,Virginia,51,139,51139,23750,11873,11877,23750,21970,443,563,,0.925052632,0.018652632,0.023705263,,,
Patrick County,Virginia,51,141,51141,17606,8888,8718,17606,16031,948,595,,0.910541861,0.05384528,0.033795297,,,
Pittsylvania County,Virginia,51,143,51143,60148,30050,30098,60148,44737,12454,1804,,0.743782004,0.207055929,0.029992685,,,
Powhatan County,Virginia,51,145,51145,31074,16258,14816,31074,26429,2743,871,,0.850518118,0.088273154,0.028029864,,,
Prince Edward County,Virginia,51,147,51147,21932,11231,10701,21932,13761,6716,1050,,0.627439358,0.306219223,0.047875251,,,
Prince George County,Virginia,51,149,51149,42873,24194,18679,42873,23474,13313,4328,,0.547524083,0.310521774,0.100949315,,,
Prince William County,Virginia,51,153,51153,484625,243640,240985,484625,225950,99527,124358,,0.466236781,0.2053691,0.256606655,,,
Pulaski County,Virginia,51,155,51155,33771,16968,16803,33771,30781,1558,725,,0.911462497,0.046134257,0.021468124,,,
Rappahannock County,Virginia,51,157,51157,7409,3791,3618,7409,6373,358,336,,0.860170063,0.048319611,0.04535025,,,
Richmond County,Virginia,51,159,51159,9047,5093,3954,9047,5517,2527,655,,0.609815408,0.279319111,0.072399691,,,
Roanoke County,Virginia,51,161,51161,96793,46903,49890,96793,81848,6161,3691,,0.845598339,0.063651297,0.038132923,,,
Rockbridge County,Virginia,51,163,51163,22578,11063,11515,22578,20222,896,512,,0.895650633,0.039684649,0.022676942,,,
Rockingham County,Virginia,51,165,51165,84739,41859,42880,84739,74665,2143,7501,,0.881117313,0.025289418,0.088518864,,,
Russell County,Virginia,51,167,51167,25635,12711,12924,25635,24863,324,167,,0.969884923,0.01263897,0.006514531,,,
Scott County,Virginia,51,169,51169,21504,10917,10587,21504,20744,257,306,,0.964657738,0.011951265,0.014229911,,,
Shenandoah County,Virginia,51,171,51171,44630,21900,22730,44630,38799,1303,3919,,0.869347972,0.029195608,0.08781089,,,
Smyth County,Virginia,51,173,51173,29585,14616,14969,29585,28119,600,605,,0.950447862,0.020280548,0.020449552,,,
Southampton County,Virginia,51,175,51175,17988,9427,8561,17988,11019,5362,414,,0.61257505,0.298087614,0.023015344,,,
Spotsylvania County,Virginia,51,177,51177,143876,71301,72575,143876,93765,23925,18251,,0.651707025,0.166289027,0.126852289,,,
Stafford County,Virginia,51,179,51179,160520,81144,79376,160520,91790,30991,25516,,0.571829056,0.193066285,0.158958385,,,
Surry County,Virginia,51,181,51181,6552,3238,3314,6552,3654,2687,191,,0.557692308,0.410103785,0.029151404,,,
Sussex County,Virginia,51,183,51183,10793,6262,4531,10793,4354,5934,165,,0.403409617,0.549800797,0.015287686,,,
Tazewell County,Virginia,51,185,51185,39933,19732,20201,39933,37261,1458,518,,0.933087922,0.036511156,0.012971728,,,
Warren County,Virginia,51,187,51187,41104,20877,20227,41104,34386,2114,2759,,0.836560919,0.051430518,0.067122421,,,
Washington County,Virginia,51,191,51191,53913,26941,26972,53913,51069,910,949,,0.947248345,0.016879046,0.017602434,,,
Westmoreland County,Virginia,51,193,51193,18683,8949,9734,18683,11895,4483,1161,,0.636675052,0.239950757,0.062142054,,,
Wise County,Virginia,51,195,51195,35727,18682,17045,35727,32407,1935,485,,0.907073082,0.054160719,0.013575167,,,
Wythe County,Virginia,51,197,51197,28219,13797,14422,28219,26413,668,421,,0.936000567,0.023671994,0.014919026,,,
York County,Virginia,51,199,51199,70590,34984,35606,70590,48789,9245,5340,,0.691160221,0.130967559,0.075648109,,,
Alexandria city,Virginia,51,510,51510,156788,76049,80739,156788,84009,33033,28540,,0.53581269,0.210685767,0.182029237,,,
Bristol city,Virginia,51,520,51520,17024,8245,8779,17024,14631,1136,458,,0.859433741,0.066729323,0.026903195,,,
Buena Vista city,Virginia,51,530,51530,6612,3161,3451,6612,5689,105,63,,0.860405324,0.015880218,0.009528131,,,
Charlottesville city,Virginia,51,540,51540,45863,22180,23683,45863,31202,7798,3103,,0.68033055,0.170028127,0.067658025,,,
Chesapeake city,Virginia,51,550,51550,251153,123363,127790,251153,141037,72892,18598,,0.561558094,0.290229462,0.074050479,,,
Colonial Heights city,Virginia,51,570,51570,18210,8289,9921,18210,12634,3285,1392,,0.693794618,0.180395387,0.076441516,,,
Covington city,Virginia,51,580,51580,5671,2676,2995,5671,4539,700,184,,0.800387939,0.12343502,0.032445777,,,
Danville city,Virginia,51,590,51590,42239,19383,22856,42239,17184,21277,2205,,0.406827813,0.503728781,0.05220294,,,
Emporia city,Virginia,51,595,51595,5633,2619,3014,5633,1161,3607,473,,0.20610687,0.640333748,0.083969466,,,
Fairfax city,Virginia,51,600,51600,24478,12073,12405,24478,13774,1565,4483,,0.562709372,0.063934962,0.183144048,,,
Falls Church city,Virginia,51,610,51610,14593,7339,7254,14593,10353,703,1555,,0.709449736,0.048173782,0.106557939,,,
Franklin city,Virginia,51,620,51620,8212,3838,4374,8212,3132,4244,259,,0.381393083,0.516804676,0.031539211,,,
Fredericksburg city,Virginia,51,630,51630,28383,13389,14994,28383,16696,5720,3508,,0.588239439,0.201529084,0.12359511,,,
Galax city,Virginia,51,640,51640,6698,2970,3728,6698,5384,327,1057,,0.803822036,0.048820543,0.157808301,,,
Hampton city,Virginia,51,650,51650,137334,65933,71401,137334,51495,67335,9084,,0.374961772,0.490301018,0.06614531,,,
Harrisonburg city,Virginia,51,660,51660,51492,24937,26555,51492,34248,3915,11890,,0.665113027,0.076031228,0.230909656,,,
Hopewell city,Virginia,51,670,51670,22944,10892,12052,22944,10179,9768,1971,,0.443645397,0.425732218,0.085904812,,,
Lexington city,Virginia,51,678,51678,7420,4176,3244,7420,6061,346,362,,0.816846361,0.046630728,0.048787062,,,
Lynchburg city,Virginia,51,680,51680,79255,37029,42226,79255,49316,21951,3920,,0.622244653,0.276966753,0.049460602,,,
Manassas city,Virginia,51,683,51683,42674,21805,20869,42674,21561,5377,18356,,0.505249098,0.126001781,0.430144819,,,
Manassas Park city,Virginia,51,685,51685,16923,8609,8314,16923,6819,1923,7771,,0.402942741,0.113632335,0.459197542,,,
Martinsville city,Virginia,51,690,51690,13584,6524,7060,13584,5860,6011,1091,,0.43138987,0.442505889,0.080315077,,,
Newport News city,Virginia,51,700,51700,184774,89871,94903,184774,78221,75773,19474,,0.423333369,0.410084752,0.105393616,,,
Norfolk city,Virginia,51,710,51710,235037,119273,115764,235037,103421,93540,23196,,0.440020082,0.397979893,0.098690844,,,
Norton city,Virginia,51,720,51720,3620,1730,1890,3620,3444,48,0,,0.951381215,0.013259669,0,,,
Petersburg city,Virginia,51,730,51730,33365,15060,18305,33365,5293,25758,2013,,0.158639293,0.772006594,0.060332684,,,
Poquoson city,Virginia,51,735,51735,12556,6338,6218,12556,11555,209,490,,0.920277158,0.016645428,0.039025167,,,
Portsmouth city,Virginia,51,740,51740,97299,46704,50595,97299,35888,50303,4942,,0.368842434,0.516994008,0.050791889,,,
Radford city,Virginia,51,750,51750,16505,7328,9177,16505,13726,1543,707,,0.83162678,0.093486822,0.042835504,,,
Richmond city,Virginia,51,760,51760,227595,108090,119505,227595,98401,95612,23439,,0.432351326,0.420097102,0.102985566,,,
Roanoke city,Virginia,51,770,51770,98677,46512,52165,98677,56758,28603,8459,,0.575189761,0.289864913,0.08572413,,,
Salem city,Virginia,51,775,51775,25477,12129,13348,25477,21389,1983,1139,,0.839541547,0.07783491,0.044706991,,,
Staunton city,Virginia,51,790,51790,25765,11882,13883,25765,20629,2830,1141,,0.80065981,0.109838929,0.044284883,,,
Suffolk city,Virginia,51,800,51800,96638,47098,49540,96638,45942,40596,4780,,0.475403051,0.420083197,0.049462944,,,
Virginia Beach city,Virginia,51,810,51810,457066,224463,232603,457066,281645,86396,40854,,0.616202036,0.189023029,0.089383153,,,
Waynesboro city,Virginia,51,820,51820,22574,10887,11687,22574,17061,2682,2071,,0.755780987,0.11880925,0.091742713,,,
Williamsburg city,Virginia,51,830,51830,15564,7339,8225,15564,10608,2372,1247,,0.68157286,0.152402981,0.080120792,,,
Winchester city,Virginia,51,840,51840,27981,13944,14037,27981,19314,2578,5611,,0.690254101,0.092133948,0.20052893,,,
Adams County,Washington,53,001,53001,20690,10606,10084,20690,9880,77,13255,,0.477525375,0.003721605,0.640647656,,,
Asotin County,Washington,53,003,53003,22424,11130,11294,22424,19939,213,996,,0.889181234,0.009498751,0.044416696,,,
Benton County,Washington,53,005,53005,210224,105883,104341,210224,151940,3563,52111,,0.722752873,0.016948588,0.24788321,,,
Chelan County,Washington,53,007,53007,79518,40075,39443,79518,54714,470,22604,,0.688070626,0.005910611,0.284262683,,,
Clallam County,Washington,53,009,53009,77593,38288,39305,77593,64256,670,5095,,0.828115938,0.0086348,0.06566314,,,
Clark County,Washington,53,011,53011,510516,253556,256960,510516,394562,10778,61186,,0.772869019,0.021111973,0.119851288,,,
Columbia County,Washington,53,013,53013,3996,2009,1987,3996,3256,28,327,,0.814814815,0.007007007,0.081831832,,,
Cowlitz County,Washington,53,015,53015,111539,55833,55706,111539,94551,779,11367,,0.847694528,0.006984104,0.101910543,,,
Douglas County,Washington,53,017,53017,43733,22622,21111,43733,27075,209,15162,,0.619097707,0.004779,0.346694716,,,
Ferry County,Washington,53,019,53019,7326,3713,3613,7326,5401,13,240,,0.737237237,0.001774502,0.032760033,,,
Franklin County,Washington,53,021,53021,97676,50261,47415,97676,50552,1888,53485,,0.517547811,0.019329211,0.547575658,,,
Garfield County,Washington,53,023,53023,2326,1240,1086,2326,2116,30,83,,0.909716251,0.012897678,0.035683577,,,
Grant County,Washington,53,025,53025,100428,51304,49124,100428,59225,1221,43512,,0.589725973,0.012157964,0.433265623,,,
Grays Harbor County,Washington,53,027,53027,76397,39200,37197,76397,61800,1241,8262,,0.808932288,0.016244093,0.108145608,,,
Island County,Washington,53,029,53029,86747,43645,43102,86747,68853,2367,7384,,0.793721973,0.027286246,0.085121099,,,
Jefferson County,Washington,53,031,53031,33313,16271,17042,33313,28880,125,1415,,0.866928827,0.003752289,0.04247591,,,
King County,Washington,53,033,53033,2262713,1146257,1116456,2262713,1283809,147642,245320,,0.567375977,0.06524999,0.108418522,,,
Kitsap County,Washington,53,035,53035,276581,142086,134495,276581,211514,7310,25018,,0.764745228,0.02642987,0.090454514,,,
Kittitas County,Washington,53,037,53037,44736,22497,22239,44736,36844,475,4626,,0.823587268,0.010617847,0.103406652,,,
Klickitat County,Washington,53,039,53039,23082,11754,11328,23082,19495,166,2981,,0.844597522,0.007191751,0.129148254,,,
Lewis County,Washington,53,041,53041,83925,42271,41654,83925,70150,648,9408,,0.835865356,0.00772118,0.112100089,,,
Lincoln County,Washington,53,043,53043,11271,5731,5540,11271,10226,59,447,,0.907284181,0.005234673,0.039659303,,,
Mason County,Washington,53,045,53045,66968,34904,32064,66968,52450,689,8128,,0.783209891,0.010288496,0.121371401,,,
Okanogan County,Washington,53,047,53047,42811,21883,20928,42811,28456,698,8676,,0.664688982,0.016304221,0.202658195,,,
Pacific County,Washington,53,049,53049,23750,11798,11952,23750,19663,138,2313,,0.827915789,0.005810526,0.097389474,,,
Pend Oreille County,Washington,53,051,53051,13811,7149,6662,13811,11909,41,521,,0.862283687,0.002968648,0.037723554,,,
Pierce County,Washington,53,053,53053,924106,464029,460077,924106,608874,66212,115594,,0.65887896,0.071649789,0.125087382,,,
San Juan County,Washington,53,055,53055,18266,8984,9282,18266,16129,48,1364,,0.883006679,0.002627833,0.074674258,,,
Skagit County,Washington,53,057,53057,130407,64927,65480,130407,100207,1132,24646,,0.76841734,0.008680516,0.188992922,,,
Skamania County,Washington,53,059,53059,12276,6241,6035,12276,10754,34,807,,0.876018247,0.002769632,0.065738025,,,
Snohomish County,Washington,53,061,53061,834648,420882,413766,834648,554564,30319,98816,,0.664428597,0.036325493,0.118392424,,,
Spokane County,Washington,53,063,53063,544323,271702,272621,544323,456164,10866,37356,,0.838039179,0.019962412,0.06862837,,,
Stevens County,Washington,53,065,53065,47470,23831,23639,47470,41194,186,1904,,0.867790183,0.003918264,0.040109543,,,
Thurston County,Washington,53,067,53067,296640,145919,150721,296640,219738,9863,30528,,0.740756472,0.033249056,0.102912621,,,
Wahkiakum County,Washington,53,069,53069,4573,2312,2261,4573,3938,50,281,,0.861141483,0.010933742,0.061447627,,,
Walla Walla County,Washington,53,071,53071,62102,31560,30542,62102,46780,1095,14538,,0.753276867,0.017632282,0.234098741,,,
Whatcom County,Washington,53,073,53073,228432,113336,115096,228432,179842,2011,23662,,0.787288996,0.008803495,0.103584437,,,
Whitman County,Washington,53,075,53075,47042,23857,23185,47042,36086,766,3783,,0.767101739,0.016283321,0.080417499,,,
Yakima County,Washington,53,077,53077,256605,128666,127939,256605,135600,2094,132408,,0.528438651,0.008160402,0.515999299,,,
Barbour County,West Virginia,54,001,54001,15454,7622,7832,15454,14093,273,184,,0.911932186,0.017665329,0.011906303,,,
Berkeley County,West Virginia,54,003,54003,126165,62899,63266,126165,103874,9046,7619,,0.82331867,0.071699758,0.060389173,,,
Boone County,West Virginia,54,005,54005,21312,10638,10674,21312,20735,91,97,,0.972926051,0.004269895,0.004551426,,,
Braxton County,West Virginia,54,007,54007,12345,6446,5899,12345,10766,108,102,,0.872093965,0.008748481,0.008262454,,,
Brooke County,West Virginia,54,009,54009,22053,10889,11164,22053,20643,316,296,,0.936063121,0.014329116,0.01342221,,,
Cabell County,West Virginia,54,011,54011,93300,45600,47700,93300,83677,3963,1582,,0.896859593,0.042475884,0.016956056,,,
Calhoun County,West Virginia,54,013,54013,6158,3014,3144,6158,5904,3,28,,0.958752842,0.000487171,0.004546931,,,
Clay County,West Virginia,54,015,54015,7946,4016,3930,7946,7714,2,15,,0.97080292,0.000251699,0.001887742,,,
Doddridge County,West Virginia,54,017,54017,7767,4366,3401,7767,7258,199,111,,0.934466332,0.025621218,0.014291232,,,
Fayette County,West Virginia,54,019,54019,39987,20010,19977,39987,36807,1803,538,,0.920474154,0.045089654,0.013454373,,,
Gilmer County,West Virginia,54,021,54021,7376,4430,2946,7376,6042,1055,266,,0.819143167,0.143031453,0.036062907,,,
Grant County,West Virginia,54,023,54023,10972,5578,5394,10972,10559,150,53,,0.962358731,0.013671163,0.004830478,,,
Greenbrier County,West Virginia,54,025,54025,32688,15752,16936,32688,30363,724,599,,0.928872981,0.022148801,0.018324767,,,
Hampshire County,West Virginia,54,027,54027,23340,11984,11356,23340,22064,153,382,,0.945329906,0.00655527,0.016366752,,,
Hancock County,West Virginia,54,029,54029,28658,14017,14641,28658,26663,563,473,,0.930385931,0.019645474,0.01650499,,,
Hardy County,West Virginia,54,031,54031,14236,7251,6985,14236,12809,700,643,,0.899761169,0.049171115,0.045167182,,,
Harrison County,West Virginia,54,033,54033,65407,32219,33188,65407,60809,853,1413,,0.929701714,0.013041418,0.021603192,,,
Jackson County,West Virginia,54,035,54035,27753,13865,13888,27753,26731,56,263,,0.963175152,0.0020178,0.009476453,,,
Jefferson County,West Virginia,54,037,54037,58546,29142,29404,58546,48075,3113,4362,,0.821149182,0.053171865,0.074505517,,,
Kanawha County,West Virginia,54,039,54039,178198,86454,91744,178198,154794,11085,2668,,0.868662948,0.062206085,0.01497211,,,
Lewis County,West Virginia,54,041,54041,16808,8401,8407,16808,15334,55,253,,0.912303665,0.003272251,0.015052356,,,
Lincoln County,West Virginia,54,043,54043,20170,10089,10081,20170,19557,1,145,,0.969608329,4.95786E-05,0.007188894,,,
Logan County,West Virginia,54,045,54045,31826,15715,16111,31826,30477,593,255,,0.957613272,0.018632565,0.008012317,,,
McDowell County,West Virginia,54,047,54047,18413,9876,8537,18413,16254,1687,357,,0.882745886,0.091620051,0.019388476,,,
Marion County,West Virginia,54,049,54049,56042,28010,28032,56042,51567,1455,878,,0.920149174,0.025962671,0.015666821,,,
Marshall County,West Virginia,54,051,54051,30129,15320,14809,30129,28376,80,335,,0.941816854,0.002655249,0.011118856,,,
Mason County,West Virginia,54,053,54053,25214,12354,12860,25214,24179,221,203,,0.958951376,0.008764972,0.008051083,,,
Mercer County,West Virginia,54,055,54055,59062,28375,30687,59062,52785,2542,771,,0.893721852,0.043039518,0.013054079,,,
Mineral County,West Virginia,54,057,54057,26922,13440,13482,26922,25096,474,316,,0.93217443,0.017606419,0.011737612,,,
Mingo County,West Virginia,54,059,54059,22979,11367,11612,22979,21960,454,111,,0.955655163,0.01975717,0.004830497,,,
Monongalia County,West Virginia,54,061,54061,106520,54986,51534,106520,93097,3834,3298,,0.873986106,0.035993241,0.030961322,,,
Monroe County,West Virginia,54,063,54063,12401,6143,6258,12401,11938,161,100,,0.962664301,0.012982824,0.008063866,,,
Morgan County,West Virginia,54,065,54065,17327,8784,8543,17327,16354,44,284,,0.943844866,0.002539389,0.016390604,,,
Nicholas County,West Virginia,54,067,54067,24446,12293,12153,24446,23639,74,130,,0.966988464,0.00302708,0.005317843,,,
Ohio County,West Virginia,54,069,54069,41904,20373,21531,41904,38009,1356,664,,0.907049446,0.032359679,0.015845743,,,
Pendleton County,West Virginia,54,071,54071,6111,3146,2965,6111,5798,131,115,,0.948780887,0.021436753,0.018818524,,,
Pleasants County,West Virginia,54,073,54073,7572,4157,3415,7572,7170,35,234,,0.946909667,0.004622293,0.030903328,,,
Pocahontas County,West Virginia,54,075,54075,7855,4139,3716,7855,7425,29,68,,0.945257798,0.003691916,0.008656906,,,
Preston County,West Virginia,54,077,54077,34204,18270,15934,34204,31006,2248,657,,0.906502163,0.065723307,0.01920828,,,
Putnam County,West Virginia,54,079,54079,57250,28512,28738,57250,54194,418,852,,0.946620087,0.00730131,0.014882096,,,
Raleigh County,West Virginia,54,081,54081,73666,36978,36688,73666,64647,5118,1252,,0.877569028,0.069475742,0.016995629,,,
Randolph County,West Virginia,54,083,54083,27782,14770,13012,27782,25195,422,301,,0.906882154,0.015189691,0.010834353,,,
Ritchie County,West Virginia,54,085,54085,8372,4186,4186,8372,8129,10,38,,0.970974677,0.001194458,0.004538939,,,
Roane County,West Virginia,54,087,54087,13921,6865,7056,13921,13398,3,164,,0.96243086,0.000215502,0.011780763,,,
Summers County,West Virginia,54,089,54089,11833,5673,6160,11833,10874,677,142,,0.918955464,0.057212879,0.012000338,,,
Taylor County,West Virginia,54,091,54091,16543,8273,8270,16543,15813,206,167,,0.955872575,0.012452397,0.010094904,,,
Tucker County,West Virginia,54,093,54093,6698,3357,3341,6698,6500,1,30,,0.970438937,0.000149298,0.004478949,,,
Tyler County,West Virginia,54,095,54095,8181,4087,4094,8181,7837,58,83,,0.957951351,0.007089598,0.010145459,,,
Upshur County,West Virginia,54,097,54097,23758,11903,11855,23758,22040,343,333,,0.927687516,0.014437242,0.014016331,,,
Wayne County,West Virginia,54,099,54099,38498,18798,19700,38498,36964,326,328,,0.960153774,0.008467972,0.008519923,,,
Webster County,West Virginia,54,101,54101,8253,4199,4054,8253,7650,16,32,,0.92693566,0.001938689,0.003877378,,,
Wetzel County,West Virginia,54,103,54103,14233,7106,7127,14233,13593,66,255,,0.955034076,0.004637111,0.01791611,,,
Wirt County,West Virginia,54,105,54105,5131,2579,2552,5131,4970,11,0,,0.968622101,0.002143832,0,,,
Wood County,West Virginia,54,107,54107,83829,41067,42762,83829,79490,975,1188,,0.948239869,0.01163082,0.014171707,,,
Wyoming County,West Virginia,54,109,54109,20948,10373,10575,20948,20314,139,92,,0.969734581,0.006635478,0.004391827,,,
Adams County,Wisconsin,55,001,55001,20928,11342,9586,20928,18799,455,893,,0.89827026,0.021741208,0.042670107,,,
Ashland County,Wisconsin,55,003,55003,16050,8249,7801,16050,13371,122,459,,0.833084112,0.007601246,0.028598131,,,
Barron County,Wisconsin,55,005,55005,46741,23483,23258,46741,43043,719,1399,,0.920883165,0.015382641,0.029930896,,,
Bayfield County,Wisconsin,55,007,55007,16410,8382,8028,16410,13873,132,330,,0.845399147,0.008043876,0.020109689,,,
Brown County,Wisconsin,55,009,55009,269425,134521,134904,269425,216766,7160,26989,,0.804550431,0.026575114,0.10017259,,,
Buffalo County,Wisconsin,55,011,55011,13341,6759,6582,13341,12695,64,363,,0.951577843,0.004797242,0.027209355,,,
Burnett County,Wisconsin,55,013,55013,16741,8596,8145,16741,15179,129,325,,0.906696135,0.007705633,0.019413416,,,
Calumet County,Wisconsin,55,015,55015,52626,26728,25898,52626,46960,498,2923,,0.892334587,0.009463003,0.055542888,,,
Chippewa County,Wisconsin,55,017,55017,66558,34496,32062,66558,61956,1040,1286,,0.930857297,0.01562547,0.019321494,,,
Clark County,Wisconsin,55,019,55019,34736,17753,16983,34736,32098,267,2116,,0.924055735,0.00768655,0.060916628,,,
Columbia County,Wisconsin,55,021,55021,58322,30012,28310,58322,53691,1094,2269,,0.920596002,0.01875793,0.038904701,,,
Crawford County,Wisconsin,55,023,55023,16064,8271,7793,16064,15028,232,307,,0.935507968,0.014442231,0.019111056,,,
Dane County,Wisconsin,55,025,55025,564777,282542,282235,564777,445942,28986,42861,,0.789589519,0.051322912,0.07589013,,,
Dodge County,Wisconsin,55,027,55027,88818,46831,41987,88818,79899,2374,5696,,0.899581166,0.026728816,0.064131145,,,
Door County,Wisconsin,55,029,55029,30279,14965,15314,30279,28252,201,1192,,0.933055913,0.006638264,0.039367218,,,
Douglas County,Wisconsin,55,031,55031,44197,22321,21876,44197,40184,560,829,,0.909201982,0.012670543,0.018756929,,,
Dunn County,Wisconsin,55,033,55033,45349,23014,22335,45349,41662,394,1080,,0.918697215,0.008688174,0.023815299,,,
Eau Claire County,Wisconsin,55,035,55035,106328,52772,53556,106328,94438,1327,3210,,0.888176209,0.01248025,0.030189602,,,
Florence County,Wisconsin,55,037,55037,4617,2353,2264,4617,4420,20,27,,0.957331601,0.004331817,0.005847953,,,
Fond du Lac County,Wisconsin,55,039,55039,104053,51761,52292,104053,92398,1762,6892,,0.887989774,0.016933678,0.066235476,,,
Forest County,Wisconsin,55,041,55041,9261,4711,4550,9261,7256,35,202,,0.783500702,0.003779289,0.021811899,,,
Grant County,Wisconsin,55,043,55043,51678,26787,24891,51678,48668,938,1273,,0.941754712,0.018150857,0.024633306,,,
Green County,Wisconsin,55,045,55045,37036,18698,18338,37036,34836,256,1509,,0.940598337,0.006912194,0.040744141,,,
Green Lake County,Wisconsin,55,047,55047,19165,9582,9583,19165,17859,150,1044,,0.931854944,0.007826768,0.054474302,,,
Iowa County,Wisconsin,55,049,55049,23832,12157,11675,23832,22252,201,522,,0.933702585,0.008434038,0.021903323,,,
Iron County,Wisconsin,55,051,55051,6164,3125,3039,6164,5827,3,96,,0.945327709,0.000486697,0.015574302,,,
Jackson County,Wisconsin,55,053,55053,20971,11269,9702,20971,18067,350,746,,0.861523056,0.016689714,0.035572934,,,
Jefferson County,Wisconsin,55,055,55055,85867,43229,42638,85867,77066,970,7181,,0.89750428,0.01129654,0.083629334,,,
Juneau County,Wisconsin,55,057,55057,26695,14335,12360,26695,23697,606,768,,0.887694325,0.02270088,0.028769432,,,
Kenosha County,Wisconsin,55,059,55059,168413,83434,84979,168413,129282,10516,24975,,0.767648578,0.062441735,0.148296153,,,
Kewaunee County,Wisconsin,55,061,55061,20621,10510,10111,20621,19307,82,827,,0.936278551,0.003976529,0.040104748,,,
La Crosse County,Wisconsin,55,063,55063,120262,59241,61021,120262,106837,1817,3146,,0.888368728,0.015108679,0.026159552,,,
Lafayette County,Wisconsin,55,065,55065,16788,8602,8186,16788,15678,96,1087,,0.933881344,0.00571837,0.06474863,,,
Langlade County,Wisconsin,55,067,55067,19473,9899,9574,19473,18109,96,469,,0.929954296,0.004929903,0.02408463,,,
Lincoln County,Wisconsin,55,069,55069,28403,14392,14011,28403,26755,144,587,,0.94197796,0.005069887,0.020666831,,,
Manitowoc County,Wisconsin,55,071,55071,81314,40991,40323,81314,72995,638,4228,,0.897692894,0.007846127,0.051995966,,,
Marathon County,Wisconsin,55,073,55073,138067,69687,68380,138067,121370,656,4641,,0.879065961,0.004751316,0.033614115,,,
Marinette County,Wisconsin,55,075,55075,41907,21255,20652,41907,39666,185,1127,,0.946524447,0.004414537,0.026892882,,,
Marquette County,Wisconsin,55,077,55077,15706,8103,7603,15706,14741,82,559,,0.938558513,0.005220935,0.035591494,,,
Menominee County,Wisconsin,55,078,55078,4256,2200,2056,4256,527,32,183,,0.123825188,0.007518797,0.04299812,,,
Milwaukee County,Wisconsin,55,079,55079,927656,450749,476907,927656,485935,241678,154350,,0.523831032,0.260525453,0.166387109,,,
Monroe County,Wisconsin,55,081,55081,46169,23711,22458,46169,41854,696,2569,,0.90653902,0.01507505,0.055643397,,,
Oconto County,Wisconsin,55,083,55083,39329,20243,19086,39329,37011,56,886,,0.941061303,0.001423886,0.022527906,,,
Oneida County,Wisconsin,55,085,55085,38007,19294,18713,38007,35737,203,639,,0.94027416,0.005341121,0.016812692,,,
Outagamie County,Wisconsin,55,087,55087,191537,96147,95390,191537,165850,3040,9773,,0.865890141,0.015871607,0.051024084,,,
Ozaukee County,Wisconsin,55,089,55089,92345,45833,46512,92345,83840,1400,3299,,0.907899724,0.015160539,0.035724728,,,
Pepin County,Wisconsin,55,091,55091,7372,3778,3594,7372,7050,21,180,,0.956321215,0.002848616,0.024416712,,,
Pierce County,Wisconsin,55,093,55093,42351,21118,21233,42351,39167,187,1227,,0.924818776,0.00441548,0.028972161,,,
Polk County,Wisconsin,55,095,55095,45327,23074,22253,45327,42720,146,980,,0.942484612,0.003221038,0.021620668,,,
Portage County,Wisconsin,55,097,55097,70375,35943,34432,70375,63719,579,2764,,0.905420959,0.008227353,0.039275311,,,
Price County,Wisconsin,55,099,55099,14077,7288,6789,14077,13240,27,232,,0.940541309,0.001918022,0.016480784,,,
Racine County,Wisconsin,55,101,55101,196888,98002,98886,196888,146063,20857,28784,,0.741858315,0.105933322,0.146194791,,,
Richland County,Wisconsin,55,103,55103,17229,8613,8616,17229,16090,150,540,,0.933890533,0.008706251,0.031342504,,,
Rock County,Wisconsin,55,105,55105,163944,81406,82538,163944,135003,7630,16163,,0.823470209,0.046540282,0.098588542,,,
Rusk County,Wisconsin,55,107,55107,14146,7257,6889,14146,13335,130,284,,0.942669306,0.009189877,0.020076347,,,
St. Croix County,Wisconsin,55,109,55109,94819,47727,47092,94819,88169,665,2789,,0.929866377,0.007013362,0.029413936,,,
Sauk County,Wisconsin,55,111,55111,65759,33013,32746,65759,58535,612,4198,,0.890144315,0.009306711,0.06383917,,,
Sawyer County,Wisconsin,55,113,55113,18243,9346,8897,18243,14205,116,430,,0.778654827,0.006358603,0.023570685,,,
Shawano County,Wisconsin,55,115,55115,40927,20598,20329,40927,35243,245,1263,,0.861118577,0.005986268,0.030859824,,,
Sheboygan County,Wisconsin,55,117,55117,117783,59881,57902,117783,99262,2443,8850,,0.842753199,0.020741533,0.075138178,,,
Taylor County,Wisconsin,55,119,55119,19972,10230,9742,19972,19003,58,565,,0.951482075,0.002904066,0.028289605,,,
Trempealeau County,Wisconsin,55,121,55121,30786,15657,15129,30786,27024,154,3914,,0.877801598,0.005002274,0.127135711,,,
Vernon County,Wisconsin,55,123,55123,30915,15677,15238,30915,29383,94,516,,0.950444768,0.003040595,0.016690927,,,
Vilas County,Wisconsin,55,125,55125,23410,12151,11259,23410,20102,80,530,,0.858692866,0.003417343,0.022639897,,,
Walworth County,Wisconsin,55,127,55127,105447,53009,52438,105447,91872,877,12545,,0.87126234,0.008316974,0.118969719,,,
Washburn County,Wisconsin,55,129,55129,16749,8442,8307,16749,15651,94,335,,0.934443847,0.005612275,0.020001194,,,
Washington County,Wisconsin,55,131,55131,137320,68768,68552,137320,126532,2137,5027,,0.921438975,0.015562191,0.036607923,,,
Waukesha County,Wisconsin,55,133,55133,409040,202810,206230,409040,359428,6307,22725,,0.878711128,0.01541903,0.055556914,,,
Waupaca County,Wisconsin,55,135,55135,51714,26401,25313,51714,48387,354,1943,,0.93566539,0.006845342,0.037572031,,,
Waushara County,Wisconsin,55,137,55137,24752,13116,11636,24752,22208,449,1715,,0.897220427,0.018139948,0.06928733,,,
Winnebago County,Wisconsin,55,139,55139,171357,87100,84257,171357,150532,4444,8464,,0.878470095,0.025934161,0.049393955,,,
Wood County,Wisconsin,55,141,55141,74039,36800,37239,74039,68081,572,2592,,0.919528897,0.007725658,0.035008577,,,
Albany County,Wyoming,56,001,56001,37713,19836,17877,37713,32047,454,3971,,0.84976003,0.012038289,0.105295256,,,
Big Horn County,Wyoming,56,003,56003,11737,6016,5721,11737,10445,61,1122,,0.889920763,0.005197239,0.095595127,,,
Campbell County,Wyoming,56,005,56005,47018,24250,22768,47018,40812,164,4408,,0.868007997,0.003488026,0.093751329,,,
Carbon County,Wyoming,56,007,56007,14549,7797,6752,14549,12192,193,2620,,0.837995739,0.013265517,0.180081105,,,
Converse County,Wyoming,56,009,56009,13759,6975,6784,13759,12979,32,1111,,0.943309834,0.00232575,0.080747147,,,
Crook County,Wyoming,56,011,56011,7339,3813,3526,7339,6871,0,145,,0.936231094,0,0.01975746,,,
Fremont County,Wyoming,56,013,56013,39472,20009,19463,39472,28347,210,2659,,0.718154641,0.005320227,0.067364208,,,
Goshen County,Wyoming,56,015,56015,12587,6556,6031,12587,11110,99,1272,,0.882656709,0.007865258,0.101056646,,,
Hot Springs County,Wyoming,56,017,56017,4618,2336,2282,4618,4207,0,181,,0.911000433,0,0.039194456,,,
Johnson County,Wyoming,56,019,56019,8602,4436,4166,8602,7940,2,364,,0.923041153,0.000232504,0.042315741,,,
Laramie County,Wyoming,56,021,56021,100661,51144,49517,100661,82733,2261,15755,,0.821897259,0.022461529,0.156515433,,,
Lincoln County,Wyoming,56,023,56023,20158,10381,9777,20158,18848,6,1054,,0.935013394,0.000297649,0.052286933,,,
Natrona County,Wyoming,56,025,56025,79735,40342,39393,79735,71297,480,7381,,0.894174453,0.006019941,0.092569135,,,
Niobrara County,Wyoming,56,027,56027,2415,1062,1353,2415,2263,34,124,,0.937060041,0.014078675,0.051345756,,,
Park County,Wyoming,56,029,56029,30109,14912,15197,30109,27140,114,1782,,0.90139161,0.003786243,0.059184961,,,
Platte County,Wyoming,56,031,56031,8606,4422,4184,8606,7555,32,732,,0.877875901,0.003718336,0.085056937,,,
Sheridan County,Wyoming,56,033,56033,31585,15857,15728,31585,29223,132,1523,,0.925217667,0.004179199,0.048219091,,,
Sublette County,Wyoming,56,035,56035,8806,4809,3997,8806,8163,2,641,,0.926981603,0.000227118,0.072791279,,,
Sweetwater County,Wyoming,56,037,56037,41786,21396,20390,41786,34434,498,6924,,0.824055904,0.011917867,0.165701431,,,
Teton County,Wyoming,56,039,56039,23358,12298,11060,23358,18793,137,3445,,0.804563747,0.005865228,0.147486942,,,
Uinta County,Wyoming,56,041,56041,20605,10399,10206,20605,18743,53,2042,,0.909633584,0.002572191,0.09910216,,,
Washakie County,Wyoming,56,043,56043,7708,3871,3837,7708,6364,14,1087,,0.825635703,0.001816295,0.141022314,,,
Weston County,Wyoming,56,045,56045,6835,3729,3106,6835,5865,4,238,,0.858083394,0.000585223,0.034820775,,,
Adjuntas Municipio,Puerto Rico,72,001,72001,17975,8694,9281,17975,14929,323,17925,,0.83054242,0.017969402,0.997218359,,,
Aguada Municipio,Puerto Rico,72,003,72003,37904,18473,19431,37904,13900,520,36344,,0.366715914,0.013718869,0.958843394,,,
Aguadilla Municipio,Puerto Rico,72,005,72005,54486,26402,28084,54486,39843,1799,53674,,0.731252065,0.033017656,0.985097089,,,
Aguas Buenas Municipio,Puerto Rico,72,007,72007,23888,11508,12380,23888,8751,1973,23789,,0.366334561,0.082593771,0.99585566,,,
Aibonito Municipio,Puerto Rico,72,009,72009,24610,11730,12880,24610,5158,1350,24562,,0.209589598,0.05485575,0.998049573,,,
Añasco Municipio,Puerto Rico,72,011,72011,25316,12194,13122,25316,6449,525,24550,,0.254740085,0.020737873,0.969742455,,,
Arecibo Municipio,Puerto Rico,72,013,72013,86875,41294,45581,86875,20816,1923,86251,,0.239608633,0.022135252,0.992817266,,,
Arroyo Municipio,Puerto Rico,72,015,72015,15573,7167,8406,15573,6951,3094,15474,,0.446349451,0.198677198,0.993642843,,,
Barceloneta Municipio,Puerto Rico,72,017,72017,22565,10623,11942,22565,5025,678,22393,,0.222690007,0.030046532,0.992377576,,,
Barranquitas Municipio,Puerto Rico,72,019,72019,28984,14208,14776,28984,12281,1929,28899,,0.423716533,0.066553961,0.997067348,,,
Bayamón Municipio,Puerto Rico,72,021,72021,183456,85774,97682,183456,45010,10021,181360,,0.245344933,0.054623452,0.988574917,,,
Cabo Rojo Municipio,Puerto Rico,72,023,72023,46955,22164,24791,46955,23799,2435,46494,,0.506846981,0.051858162,0.990182089,,,
Caguas Municipio,Puerto Rico,72,025,72025,126239,58316,67923,126239,56949,10898,123842,,0.451120494,0.086328314,0.981012207,,,
Camuy Municipio,Puerto Rico,72,027,72027,32753,15506,17247,32753,24474,727,32451,,0.747229261,0.02219644,0.990779471,,,
Canóvanas Municipio,Puerto Rico,72,029,72029,42037,20096,21941,42037,9035,5964,42001,,0.214929705,0.141875015,0.999143612,,,
Carolina Municipio,Puerto Rico,72,031,72031,153226,69641,83585,153226,43434,20711,151217,,0.283463642,0.135166356,0.986888648,,,
Cataño Municipio,Puerto Rico,72,033,72033,22768,10683,12085,22768,5814,1855,22485,,0.255358398,0.081473999,0.987570274,,,
Cayey Municipio,Puerto Rico,72,035,72035,41231,19697,21534,41231,15144,3444,41081,,0.367296452,0.083529383,0.996361961,,,
Ceiba Municipio,Puerto Rico,72,037,72037,11128,5198,5930,11128,1887,534,10931,,0.16957225,0.04798706,0.982296909,,,
Ciales Municipio,Puerto Rico,72,039,72039,16874,8147,8727,16874,5759,864,16801,,0.341294299,0.051203034,0.995673818,,,
Cidra Municipio,Puerto Rico,72,041,72041,39765,19148,20617,39765,12990,4507,39654,,0.326669181,0.113340878,0.997208601,,,
Coamo Municipio,Puerto Rico,72,043,72043,34294,16601,17693,34294,6382,2733,34194,,0.186096693,0.079693241,0.997084038,,,
Comerío Municipio,Puerto Rico,72,045,72045,18775,9371,9404,18775,5720,1984,18775,,0.304660453,0.105672437,1,,,
Corozal Municipio,Puerto Rico,72,047,72047,34474,16593,17881,34474,10869,2577,34361,,0.315281081,0.074751987,0.996722167,,,
Culebra Municipio,Puerto Rico,72,049,72049,1281,666,615,1281,326,22,1170,,0.254488681,0.017174083,0.913348946,,,
Dorado Municipio,Puerto Rico,72,051,72051,35816,17402,18414,35816,11262,2014,34782,,0.314440474,0.056231852,0.971130221,,,
Fajardo Municipio,Puerto Rico,72,053,72053,31756,14734,17022,31756,6837,1869,31463,,0.215297896,0.05885502,0.990773397,,,
Florida Municipio,Puerto Rico,72,054,72054,11624,5401,6223,11624,2963,67,11592,,0.254903648,0.005763937,0.997247075,,,
Guánica Municipio,Puerto Rico,72,055,72055,13266,6461,6805,13266,7446,473,13159,,0.561284487,0.035655058,0.991934268,,,
Guayama Municipio,Puerto Rico,72,057,72057,35845,17775,18070,35845,17305,3460,35741,,0.482773051,0.096526712,0.997098619,,,
Guayanilla Municipio,Puerto Rico,72,059,72059,17418,8203,9215,17418,13835,407,17364,,0.79429326,0.023366632,0.996899759,,,
Guaynabo Municipio,Puerto Rico,72,061,72061,89503,41950,47553,89503,27045,4237,87829,,0.302168642,0.047339195,0.981296716,,,
Gurabo Municipio,Puerto Rico,72,063,72063,40383,18936,21447,40383,13916,4195,39120,,0.344600451,0.103880346,0.968724463,,,
Hatillo Municipio,Puerto Rico,72,065,72065,38266,18229,20037,38266,27523,1441,38040,,0.719254691,0.03765745,0.994093974,,,
Hormigueros Municipio,Puerto Rico,72,067,72067,15520,7163,8357,15520,4535,523,15237,,0.292203608,0.033698454,0.981765464,,,
Humacao Municipio,Puerto Rico,72,069,72069,50441,23789,26652,50441,7368,2678,49800,,0.146071648,0.053091731,0.987292084,,,
Isabela Municipio,Puerto Rico,72,071,72071,42878,20859,22019,42878,22672,2652,41935,,0.528756005,0.0618499,0.97800737,,,
Jayuya Municipio,Puerto Rico,72,073,72073,14653,7077,7576,14653,8333,312,14410,,0.568689006,0.021292568,0.983416365,,,
Juana Díaz Municipio,Puerto Rico,72,075,72075,46276,21913,24363,46276,7149,2608,46150,,0.154486127,0.056357507,0.997277206,,,
Juncos Municipio,Puerto Rico,72,077,72077,36895,17473,19422,36895,13338,5722,36776,,0.3615124,0.155088765,0.996774631,,,
Lajas Municipio,Puerto Rico,72,079,72079,23133,11074,12059,23133,11766,771,22632,,0.508624044,0.033329011,0.978342627,,,
Lares Municipio,Puerto Rico,72,081,72081,27944,13785,14159,27944,22728,588,27734,,0.813340968,0.021042084,0.99248497,,,
Las Marías Municipio,Puerto Rico,72,083,72083,8790,4360,4430,8790,5497,262,8750,,0.625369738,0.029806598,0.995449374,,,
Las Piedras Municipio,Puerto Rico,72,085,72085,35034,16729,18305,35034,2856,6069,34935,,0.081520808,0.173231718,0.997174174,,,
Loíza Municipio,Puerto Rico,72,087,72087,23176,10752,12424,23176,2800,7920,23113,,0.120814636,0.341732827,0.997281671,,,
Luquillo Municipio,Puerto Rico,72,089,72089,17631,8232,9399,17631,3507,1131,17437,,0.198911009,0.064148375,0.988996654,,,
Manatí Municipio,Puerto Rico,72,091,72091,39152,18230,20922,39152,9664,840,38191,,0.246832857,0.021454843,0.975454638,,,
Maricao Municipio,Puerto Rico,72,093,72093,5176,2550,2626,5176,3441,9,5114,,0.664799073,0.001738794,0.988021638,,,
Maunabo Municipio,Puerto Rico,72,095,72095,10482,5241,5241,10482,858,2060,10444,,0.081854608,0.19652738,0.996374738,,,
Mayagüez Municipio,Puerto Rico,72,097,72097,71824,34334,37490,71824,10930,1651,71154,,0.152177545,0.022986745,0.990671642,,,
Moca Municipio,Puerto Rico,72,099,72099,37402,18255,19147,37402,28316,1518,37192,,0.757071814,0.040586065,0.994385327,,,
Morovis Municipio,Puerto Rico,72,101,72101,28534,14123,14411,28534,7887,1336,28505,,0.276407093,0.046821336,0.998983669,,,
Naguabo Municipio,Puerto Rico,72,103,72103,23205,10731,12474,23205,4507,298,22959,,0.194225382,0.01284206,0.989398836,,,
Naranjito Municipio,Puerto Rico,72,105,72105,29246,14479,14767,29246,9784,2063,29234,,0.334541476,0.070539561,0.999589687,,,
Orocovis Municipio,Puerto Rico,72,107,72107,21351,10641,10710,21351,7594,994,21202,,0.355674207,0.046555196,0.993021404,,,
Patillas Municipio,Puerto Rico,72,109,72109,15753,7621,8132,15753,777,3269,15753,,0.049323938,0.207516029,1,,,
Peñuelas Municipio,Puerto Rico,72,111,72111,20082,9698,10384,20082,15731,323,19925,,0.783338313,0.016084055,0.992182054,,,
Ponce Municipio,Puerto Rico,72,113,72113,134676,64113,70563,134676,55582,6546,133695,,0.41270902,0.048605542,0.992715851,,,
Quebradillas Municipio,Puerto Rico,72,115,72115,23486,11327,12159,23486,13847,700,23117,,0.589585285,0.02980499,0.984288512,,,
Rincón Municipio,Puerto Rico,72,117,72117,15276,7114,8162,15276,3270,354,14559,,0.214061273,0.023173606,0.953063629,,,
Río Grande Municipio,Puerto Rico,72,119,72119,46478,22210,24268,46478,8713,5384,46120,,0.187465037,0.115839752,0.992297431,,,
Sabana Grande Municipio,Puerto Rico,72,121,72121,22541,10473,12068,22541,13021,181,22369,,0.577658489,0.008029812,0.99236946,,,
Salinas Municipio,Puerto Rico,72,123,72123,25397,12237,13160,25397,4461,2689,25178,,0.175650667,0.105878647,0.991376934,,,
San Germán Municipio,Puerto Rico,72,125,72125,31514,15328,16186,31514,21074,307,31223,,0.668718665,0.009741702,0.990766009,,,
San Juan Municipio,Puerto Rico,72,127,72127,338661,154655,184006,338661,109176,36212,331642,,0.322375473,0.106926986,0.97927426,,,
San Lorenzo Municipio,Puerto Rico,72,129,72129,37515,18225,19290,37515,2448,6430,37390,,0.065253898,0.171398107,0.996667999,,,
San Sebastián Municipio,Puerto Rico,72,131,72131,39168,19037,20131,39168,28126,901,38191,,0.718086193,0.023003472,0.975056168,,,
Santa Isabel Municipio,Puerto Rico,72,133,72133,20064,9627,10437,20064,3749,1507,19938,,0.186852073,0.075109649,0.993720096,,,
Toa Alta Municipio,Puerto Rico,72,135,72135,66536,31794,34742,66536,24157,3059,66029,,0.363066611,0.045975111,0.992380065,,,
Toa Baja Municipio,Puerto Rico,72,137,72137,73987,34261,39726,73987,18960,5100,73438,,0.256261235,0.068931028,0.992579778,,,
Trujillo Alto Municipio,Puerto Rico,72,139,72139,67329,31444,35885,67329,25785,7773,66810,,0.382970191,0.115448024,0.992291583,,,
Utuado Municipio,Puerto Rico,72,141,72141,27896,13440,14456,27896,15515,491,27371,,0.556172928,0.01760109,0.981180098,,,
Vega Alta Municipio,Puerto Rico,72,143,72143,35114,16854,18260,35114,7703,1739,34890,,0.219371191,0.049524406,0.993620778,,,
Vega Baja Municipio,Puerto Rico,72,145,72145,54058,25765,28293,54058,13681,2249,53036,,0.253080025,0.041603463,0.98109438,,,
Vieques Municipio,Puerto Rico,72,147,72147,8147,4178,3969,8147,1028,222,7803,,0.126181416,0.027249294,0.957775868,,,
Villalba Municipio,Puerto Rico,72,149,72149,21778,10510,11268,21778,7552,2219,21700,,0.346771972,0.101891817,0.996418404,,,
Yabucoa Municipio,Puerto Rico,72,151,72151,29868,14381,15487,29868,2001,5900,29732,,0.066994777,0.197535824,0.995446632,,,
Yauco Municipio,Puerto Rico,72,153,72153,33509,15920,17589,33509,24597,649,33243,,0.734041601,0.019367931,0.992061834,,,